AAPG Bulletin = AAPG Bull.
AAPG Memoir = AAPG Mem.
AGSO Journal of Australian Geology and Geophysics = AGSO J. Aust. Geol. Geophys.
Acta Geologica Sinica = Acta Geol. Sin.
Acta Geophysica = Acta Geophys.
Acta Geotechnica = Acta Geotech.
Acta Seismologica Sinica = Acta Seismol. Sin.
Advances in Fluid Mechanics = Adv. Fluid Mech.
Advances in Physics = Adv. Phys.
Advances in Space Research = Adv. Space Res.
Advances in Water Resources = Adv. Water Res.
Advances in X-Ray Analysis = Adv. X-Ray Anal.
American Association of Petroleum Geologists Bulletin = Am. Assoc. Pet. Geol. Bull.
American Journal of Physics = Am. J. Phys.
American Journal of Science = Am. J. Sci.
American Laboratory = Am. Lab.
American Mineralogist = Am. Mineral.
Analytical Letters = Anal. Lett.
Analytical Methods = Anal. Methods
Analytical Sciences = Anal. Sci.
Andean Geology = Andean Geol.
Annual Review of Astronomy and Astrophysics = Annu. Rev. Astron. Astrophys.
Annals of GIS = Ann. Gis
Annals of Glaciology = Ann. Glaciol.
Annals of Physics = Ann. Phys.
Annals of the New York Academy of Sciences = Ann. N.Y. Acad. Sci.
Annual Review of Earth and Planetary Sciences = Annu. Rev. Earth Planet. Sci.
Annual Review of Fluid Mechanics = Annu. Rev. Fluid Mech.
Antarctic Science = Antarct. Sci.
Anticancer Research = Anticancer Res.
Applied Geochemistry = Appl. Geochem.
Applied Geography = Appl. Geogr.
Applied Geophysics = Appl. Geophys.
Applied Mathematics and Computation = Appl. Math. Comput.
Applied Mathematical Modelling = Appl. Math. Modell.
Applied Mathematics Letters = Appl. Math. Lett.
Applied Mechanics Reviews = Appl. Mech. Rev.
Applied Physics A = Appl. Phys. A
Applied Physics B = Appl. Phys. B
Applied Physics Letters = Appl. Phys. Lett.
Applied Scientific Research = Appl. Sci. Res.
Aquatic Geochemistry = Aquat. Geochem.
Aquatic Sciences = Aquat. Sci.
Archives of Mining Sciences = Arch. Min. Sci.
Asian Journal of Experimental Sciences = Asian J. Exp. Sci.
Asian Journal of Physics = Asian J. Phys.
Astronomical Journal = Astron. J.
Astronomische Nachrichten = Astron. Nachr.
Astronomy & Geophysics = Astron. Geophys.
Astronomy Journal = Astron. J.
Astronomy Letters = Astron. Lett.
Astronomy and Astrophysics = Astron. Astrophys.
Astronomy and Astrophysics Review = Astron. Astrophys. Rev.
Astroparticle Physics = Astropart. Phys.
Astrophysical Bulletin = Astrophys. Bull.
Astrophysics Journal = Astrophys. J.
Astrophysics Journal Supplement Series = Astrophys. J. Suppl. Ser.
Astrophysics and Space Science = Astrophys. Space Sci.
Atomization and Sprays = Atomization Sprays
Australian Gemmologist = Aust. Gemmol.
Australian Journal of Basic and Applied Sciences = Aust. J. Basic Appl. Sci.
Australian Journal of Crop Science = Aust. J. Crop Sci.
Australian Journal of Earth Sciences = Aust. J. Earth Sci.
Australian Journal of Grape and Wine Research = Aust. J. Grape Wine Res.
Australian Journal of Physics = Aust. J. Phys.
BMR Journal of Geology and Geophysics = BMR J. Aust. Geol. Geophys.
Basin Research = Basin Res.
Bayer CropScience Journal = Bayer CropSci J.
Bell Laboratories Record = Bell Lab. Rec.
Boundary-Layer Meteorology = Boundary Layer Meteorol.
British Journal of Applied Physics = Br. J. Appl. Phys.
Bulletin of Canadian Petroleum Geology = Bull. Can. Petrol. Geol.
Bulletin of ECerS = Bull. ECerS
Bulletin of Engineering Geology and the Environment = Bull. Eng. Geol. Env.
Bulletin of Glaciological Research = Bull. Glaciol. Res.
Bulletin of Volcanology = Bull. Volcanol.
Bulletin of the American Meteorological Society = Bull. Am. Meteorol. Soc.
Bulletin of the Geological Society of Denmark = Bull. Geol. Soc. Den.
Bulletin of the Seismological Society of America = Bull. Seismol. Soc. Am.
Bureau of Mines Information Circular = Bur. Mines Inf. Circ.
CIM Bulletin = CIM Bull.
CIRP Annals = CIRP Ann.
COSPAR Colloquia Series = COSPAR Colloq. Ser.
Canadian Journal of Earth Sciences = Can. J. Earth Sci.
Canadian Journal of Genetics and Cytology = Can. J. Genet. Cytol.
Canadian Journal of Physics = Can. J. Phys.
Canadian Journal of Research = Can. J. Res.
Canadian Mineralogist = Can. Mineral.
Canadian Mining Journal = Can. Min. J.
Chaos, Solitons & Fractals = Chaos, Solitons Fractals
Chinese Astronomy and Astrophysics = Chin. Astron. Astrophy
Chinese Journal of Aeronautics = Chin. J. Aeronaut.
Chinese Journal of Astronomy and Astrophysics = Chin. J. Astron. Astrophys.
Chinese Journal of Geochemistry = Chin. J. Geochem.
Chinese Journal of Physics = Chin. J. Phys.
Chinese Physics = Chin. Phys.
Chinese Physics B = Chin. Phys. B
Chinese Physics C = Chin. Phys. C
Chinese Physics Letters = Chin. Phys. Lett.
Chinese Science Bulletin = Chin. Sci. Bull.
Chinese-German Journal of Clinical Oncology = Chin. Ger. J. Clin. Oncol.
Combinatorics, Probability and Computing = Comb. Probab. Comput.
Composite Interfaces = Compos. Interfaces
Composite Structures = Compos. Struct.
Computational Intelligence = Comput. Intell.
Computational Mathematics and Mathematical Physics = Comput. Math. Math. Phys.
Computational Mechanics = Comput. Mech.
Computational Science & Discovery = Comput. Sci. Discovery
Computational Statistics and Data Analysis = Comput. Stat. Data Anal.
Computing Letters = Comput. Lett.
Condensed Matter Physics = Condens. Matter Phys.
Condensed Matter Theories = Condens. Matter Theor.
Contemporary Physics = Contemp. Phys.
Continental Shelf Research = Cont. Shelf Res.
Cosmic Research = Cosmic Res.
Current Applied Physics = Curr. Appl Phys.
Dalton Transactions = Dalton Trans.
Digital Signal Processing = Digital Signal Process.
Earth and Planetary Science Letters = Earth Planet. Sci. Lett.
Earth Science Frontiers = Earth Sci. Front.
Earth Science Informatics = Earth Sci. Inf.
Earth Sciences Research Journal = Earth Sci. Res. J.
Earth-Science Reviews = Earth Sci. Rev.
European Journal of Applied Mathematics = Eur. J. Appl. Math.
European Journal of Mechanics - A/Solids = Eur. J. Mech. A. Solids
European Journal of Mechanics - B/Fluids = Eur. J. Mech. B. Fluids
European Journal of Mineralogy = Eur. J. Mineral.
European Journal of Phycology = Eur. J. Phycol.
European Journal of Physics = Eur. J. Phys.
European Physical Journal Applied Physics = Eur. Phys. J. Appl. Phys.
European Physical Journal B: Condensed Matter and Complex Systems = Eur. Phys. J. B
Experimental Astronomy = Exp. Astron.
Experimental Heat Transfer = Exp. Heat Transfer
Experimental Hematology = Exp. Hematol.
Experimental Mechanics = Exp. Mech.
Experimental Mycology = Exp. Mycol.
Experimental and Clinical Psychopharacology = Exp. Clin. Psychopharmacol.
Experiments in Fluids = Exp. Fluids
Expert Systems with Applications = Expert Syst. Appl.
Exploration Geophysics = Explor. Geophys.
Exploration and Mining Geology = Explor. Min. Geol.
Faraday Discussions = Faraday Discuss.
Frontier Science Series = Front. Sci. Ser.
Frontiers of Earth Science in China = Front Earth Sci. Chin.
Fuzzy Sets and Systems = Fuzzy Sets Syst.
Gas Separation and Purification = Gas Sep. Purif.
Gaswaerme International = Gaswaerme Int.
General Relativity and Gravitation = Gen. Relativ. Gravitation
Geo-Marine Letters = Geo-Mar. Lett.
Geochimica et Cosmochimica Acta = Geochim. Cosmochim. Acta
Geochemical Journal = Geochem. J.
Geochemical Transactions = Geochem. Trans.
Geochemistry International = Geochem. Int.
Geochemistry, Geophysics, Geosystems = Geochem. Geophys. Geosyst.
Geological Journal = Geol. J.
Geological Magazine = Geol. Mag.
Geological Society Special Publication = Geol. Soc. Spec. Pub.
Geological Society Special Publications = Geol. Soc. Spec.Publ.
Geological Society of America Bulletin = Geol. Soc. Am. Bull.
Geological Society of America Special Papers = Geol. Soc. Spec. Pap.
Geological Society, London, Special Publications = Geol. Soc. London Spec. Publ.
Geologie en Mijnbouw = Geol. Mijnbouw
Geologische Rundschau = Geol. Rundsch.
Geologisches Jahrbuch = Geol. Jahrb.
Geologiska Foereningens i Stockholm Foerhandlingar = GFF
Geologiya i Geofizika = Geol. Geofiz.
Geology Today = Geol. Today
Geology of Ore Deposits = Geol. Ore Deposits
Geomagnetism and Aeronomy = Geomag. Aeron.
Geomechanics and Geoengineering = Geomech. Geoeng.
Geomechanics and Tunnelling = Geomech. Tunnelling
Geophysical Journal = Geophys. J
Geophysical Journal International = Geophys. J. Int.
Geophysical Magazine = Geophys. Mag.
Geophysical Prospecting = Geophys. Prospect.
Geophysical Research Letters = Geophys. Res. Lett.
Geosciences Journal = Geosci. J.
Geostandards and Geoanalytical Research = Geostand. Geoanal. Res.
Geotechnical Testing Journal = Geotech. Test. J.
Geotextiles and Geomembranes = Geotext. Geomembr.
Glass Research = Glass Res.
Global Journal of Geological Sciences = Global J. Geol. Sci.
Global Journal of Pure and Applied Sciences = Global J. Pure Appl. Sci.
Gravitation and Cosmology = Gravitation Cosmol.
Greenland Geoscience = Greenl. Geosci.
Ground Water = Ground Water
Ground Water Monitoring Review = Ground Water Monit. Rev.
Ground Water Monitoring and Remediation = Ground Water Monit. Rem.
Heat Recovery Systems and CHP = Heat Recovery Syst. CHP
Heat Transfer - Asian Research = Heat Transfer Asian Res.
Heat and Mass Transfer = Heat Mass Transfer
Helvetica Physica Acta = Helv. Phys. Acta
Himalayan Geology = Himalayan Geol.
Hydrogeology Journal = Hydrol. J.
Hydrological Processes = Hydrol. Processes
Hydrological Sciences Bulletin = Hydrol. Sci. Bull.
Hydrological Sciences Journal = Hydrol. Sci. J.
IEEE Geoscience and Remote Sensing Letters = IEEE Geosci. Remote Sens. Lett.
IEEE Transactions on Geoscience and Remote Sensing = IEEE Trans. Geosci. Remote Sens.
IET Image Processing = IET Image Proc.
International Applied Mechanics = Int. Appl. Mech.
International DATA Series, Selected Data on Mixtures, Series A = Int. DATA Ser., Sel. Data Mixtures, Ser. A
International Geology Review = Int. Geol. Rev.
International Journal for Numerical Methods in Fluids = Int. J. Numer. Methods Fluids
International Journal for Numerical and Analytical Methods in Geomechanics = Int. J. Numer. Anal. Methods Geomech.
International Journal of Alternative Propulsion = Int. J. Altern. Propul.
International Journal of Antimicrobial Agents = Int. J. Antimicrob. Agents
International Journal of Applied Earth Observation and Geoinformation = Int. J. Appl. Earth Obs. Geoinf.
International Journal of Applied Glass Science = Int. J. Appl. Glass Sci.
International Journal of Applied Systemic Studies = Int. J. Appl. Syst. Stud.
International Journal of Approximate Reasoning = Int. J. Approximate Reasoning
International Journal of Aromatherapy = Int. J. Aromather.
International Journal of Bifurcation and Chaos = Int. J. Bifurcation Chaos
International Journal of Cement Composites and Lightweight Concrete = Int. J. Cem. Compos. Lightweight Concrete
International Journal of Circuit Theory and Applications = Int. J. Circuit Theory Appl.
International Journal of Climatology = Int. J. Climatol.
International Journal of Coal Geology = Int. J. Coal Geol.
International Journal of Computational Intelligence and Applications = Int. J. Comput. Intell. Appl.
International Journal of Computational Methods = Int. J. Comput. Methods
International Journal of Computing Science and Mathematics = Int. J. Comput. Sci. Math.
International Journal of Condensed Matter Research = Int. J. Condens. Matter Res.
International Journal of Cosmetic Science = Int. J. Cosmet. Sci.
International Journal of Crashworthiness = Int. J. Crashworthiness
International Journal of Critical Infrastructures = Int. J. Crit. Infrastruct.
International Journal of Damage Mechanics = Int. J. Damage Mech
International Journal of Data Warehousing and Mining = Int. J. Data Warehouse. Min.
International Journal of Digital Earth = Int. J. Digital Earth
International Journal of Earth Sciences = Int. J. Earth Sci.
International Journal of Embedded Systems = Int. J. Embedded Syst.
International Journal of Engine Research = Int. J. Engine Res.
International Journal of Enterprise Information Systems = Int. J. Enterp. Inf. Syst.
International Journal of Exergy = Int. J. Exergy
International Journal of Fatigue = Int. J. Fatigue
International Journal of Fluid Mechanics Research = Int. J. Fluid Mech. Res.
International Journal of Forming Processes = Int. J. Form. Processes
International Journal of Fracture = Int. J. Fract.
International Journal of Fracture Mechanics = Int. J. Fract.Mech.
International Journal of Fuzzy Systems = Int. J. Fuzzy Syst.
International Journal of General Systems = Int. J. Gen. Syst.
International Journal of Geomechanics = Int. J. Geomech.
International Journal of Geometric Methods in Modern Physics = Int. J. Geom. Meth. Mod. Phys.
International Journal of Grid and Utility Computing = Int. J. Grid Util. Comput.
International Journal of Heat Exchangers = Int. J. Heat Exch.
International Journal of Heat and Fluid Flow = Int. J. Heat Fluid Flow
International Journal of Heat and Mass Transfer = Int. J. Heat Mass Transfer
International Journal of Heavy Vehicle Systems = Int. J. Heavy Veh. Syst.
International Journal of High Performance Computing Applications = Int. J. High Perform. Comput. Appl.
International Journal of High Performance Computing and Networking = Int. J. High Perform. Comput. Networking
International Journal of High Performance Systems Architecture = Int. J. High Perform. Syst. Archit.
International Journal of Immunopharmacology = Int. J. Immunopharmacol
International Journal of Information Quality = Int. J. Inf. Qual.
International Journal of Information Security = Int. J. Inf. Secur.
International Journal of Innovative Computing and Applications = Int. J. Innovative Comput. Appl.
International Journal of Intelligent Information and Database Systems = Int. J. Intell. Inf. Database Syst.
International Journal of Intelligent Systems = Int. J. Intell. Syst.
International Journal of Life Cycle Assessment = Int. J. Life Cycle Assess.
International Journal of Man-Machine Studies = Int. J. Man Mach. Stud.
International Journal of Mechanical Sciences = Int. J. Mech. Sci.
International Journal of Metadata, Semantics and Ontologies = Int. J. Metadata Semant. Ontol.
International Journal of Mine Water = Int. J. Mine Water
International Journal of Mineral Processing = Int. J. Miner. Process.
International Journal of Modelling and Simulation = Int. J. Model. Simul.
International Journal of Modern Physics A = Int. J. Mod. Phys. A
International Journal of Modern Physics B = Int. J. Mod. Phys. B
International Journal of Modern Physics C = Int. J. Mod. Phys. C
International Journal of Modern Physics D = Int. J. Mod. Phys. D
International Journal of Modern Physics E = Int. J. Mod. Phys. E
International Journal of Multiphase Flow = Int. J. Multiphase Flow
International Journal of Multiphysics = Int. J. Multiphys.
International Journal of Neural Systems = Int. J. Neural Syst.
International Journal of Non-Equilibrium Processing = Int. J. Non Equilibr. Process
International Journal of Non-Linear Mechanics = Int. J. Non Linear Mech.
International Journal of Nondestructive Testing = Int. J. Nondestr. Test.
International Journal of Numerical Methods for Heat and Fluid Flow = Int. J. Numer. Methods Heat Fluid Flow
International Journal of Oncology = Int. J. Oncol.
International Journal of Optomechatronics = Int. J. Optomechatronics
International Journal of PIXE = Int. J. PIXE
International Journal of Peptide Research and Therapeutics = Int. J. Pept. Res. Ther.
International Journal of Phycology and Phycochemistry = Int. J. Phycol. Phycochem.
International Journal of Pressure Vessels and Piping = Int. J. Press. Vessels Pip.
International Journal of Refrigeration = Int. J. Refrig
International Journal of Rehabilitation Research = Int. J. Rehabil. Res.
International Journal of Reliability and Safety = Int. J. Reliab. Saf.
International Journal of Remote Sensing = Int. J. Remote Sens.
International Journal of Rock Mechanics and Mining Sciences = Int. J. Rock Mech. Min. Sci.
International Journal of Rotating Machinery = Int. J. Rotating Mach.
International Journal of Security and Networks = Int. J. Secur. Netw.
International Journal of Sediment Research = Int. J. Sediment Res.
International Journal of Services Operations and Informatics = Int. J. Serv. Oper. Inf.
International Journal of Shape Modeling = Int. J. Shaping Model.
International Journal of Simulation and Process Modelling = Int. J. Simul. Process Model.
International Journal of Soft Computing = Int. J. Soft Comput.
International Journal of Solids and Structures = Int. J. Solids Struct.
International Journal of Space Structures = Int. J. Space Struct.
International Journal of Sustainable Development = Int. J. Sustainable Dev.
International Journal of Systems Science = Int. J. Syst. Sci.
International Journal of Theoretical Physics = Int. J. Theor. Phys.
International Journal of Thermodynamics = Int. J. Thermodyn.
International Journal of Thermophysics = Int. J. Thermophys.
International Journal of Tropical Insect Science = Int. J. Trop. Insect Sci.
International Journal of Uncertainty, Fuzziness and Knowlege-Based Systems = Int. J. Uncertainty Fuzziness Knowledge Based Syst.
International Journal of Vehicle Autonomous Systems = Int. J. Veh. Auton. Syst.
International Journal of Vehicle Noise and Vibration = Int. J. Veh. Noise Vib.
International Journal of Vehicle Safety = Int. J. Veh. Saf.
International Journal of Vehicle Systems Modelling and Testing = Int. J. Veh. Syst. Model. Test.
International Journal of Ventilation = Int. J. Vent.
International Journal of Water = Int. J. Water
International Journal of Water Resources Development = Int. J. Water Resour. Dev.
International Journal of Web Services Research = Int. J. Web Serv. Res.
International Journal of Web and Grid Services = Int. J. Web Grid Serv.
International Journal of Wireless Information Networks = Int. J. Wireless Inf. Networks
International Journal of Wireless and Mobile Computing = Int. J. Wireless Mobile Comput.
International Journal on Algae = Int. J. Algae
International Journal on Artificial Intelligence Tools = Int. J. Artif. Intell. Tools
International Journal on Document Analysis and Recognition = Int. J. Doc. Anal. Recogn.
International Journal on Hydropower and Dams = Int. J. Hydropower Dams
International Nonwovens Journal = Int. Nonwovens J.
Inverse Problems = Inverse Prob.
Ion Exchange and Solvent Extraction = Ion Exch. Solvent Extr.
Ironmaking and Steelmaking = Ironmaking Steelmaking
Isotope Geoscience = Isot. Geosci.
Izvestiya Physics of the Solid Earth = Izv. Phys. Solid Earth
JETP Letters = JETP Lett.
Jahrbuch Oberflachentechnik = Jahrb. Oberflachentech.
Japanese Journal of Applied Physics Part 1 = Jpn. J. Appl. Phys., Part 1
Japanese Journal of Applied Physics Part 2 = Jpn. J. Appl. Phys., Part 2
Japanese Journal of Phycology = Jpn. J. Phycol.
Journal American Water Works Association = J. Am. Water Works Assn.
Journal of AOAC International = J. AOAC Int.
Journal of ASTM International = J. ASTM Int.
Journal of Applied Geophysics = J. Appl. Geophys.
Journal of Applied Mathematics and Computing = J. Appl. Math. Comput.
Journal of Applied Mathematics and Mechanics = J. Appl. Math. Mech.
Journal of Applied Mechanics = J. Appl. Mech.
Journal of Applied Phycology = J. Appl. Phycol.
Journal of Applied Physics = J. Appl. Phys.
Journal of Applied Remote Sensing = J. Appl. Remote Sens.
Journal of Applied Systems Analysis = J. Appl. Syst. Anal.
Journal of Asian Earth Sciences = J. Asian Earth Sci.
Journal of Astronautical Sciences = J. Astronaut. Sci.
Journal of Astrophysics and Astronomy = J. Astrophys. Astron.
Journal of Computational Physics = J. Comput. Phys.
Journal of Computational and Applied Mathematics = J. Comput. Appl. Math.
Journal of Contemporary Physics = J. Contemp. Phys.
Journal of Earth Science = J. Earth Sci.
Journal of Earth System Science = J. Earth Syst. Sci.
Journal of Elasticity = J. Elast.
Journal of Experimental and Theoretical Physics = J. Exp. Theor. Phys.
Journal of Fire Sciences = J. Fire Sci.
Journal of Fluid Mechanics = J. Fluid Mech.
Journal of Fluids and Structures = J. Fluids Struct.
Journal of Geochemical Exploration = J. Geochem. Explor.
Journal of Geodesy = J. Geod.
Journal of Geodynamics = J. Geodyn.
Journal of Geographical Sciences = J. Geog. Sci.
Journal of Geology = J. Geol.
Journal of Geometry and Physics = J. Geom. Phys.
Journal of Geophysical Research = J. Geophys. Res.
Journal of Geophysical Research, A: Space Physics = J. Geophys. Res. A: Space Phys.
Journal of Geophysical Research, B: Solid Earth = J. Geophys. Res. B: Solid Earth
Journal of Geophysical Research, Earth Surface = J. Geophys. Res. Earth Surf.
Journal of Geophysical Research, Oceans = J. Geophys. Res. Oceans
Journal of Geophysical Research, Solid Earth = J. Geophys. Res. Solid Earth
Journal of Geophysical Research, Space Physics = J. Geophys. Res. Space Phys.
Journal of Geophysics = J. Geophys.
Journal of Geosciences = J. Geosci.
Journal of Great Lakes Research = J. Great Lakes Res.
Journal of Hazardous materials = J. Hazard. Mater.
Journal of Heat Transfer = J. Heat Transfer
Journal of Heat Treating = J. Heat. Treat.
Journal of Hydro-environment Research = J. Hydro-environ. Res.
Journal of Hydrodynamics, Series B = J. Hydrodyn. Ser. B
Journal of Hydrology = J. Hydrol.
Journal of Marine Research = J. Mar. Res.
Journal of Marine Science and Application = J. Mar. Sci. Appl.
Journal of Marine Systems = J. Mar. Sys.
Journal of Mathematical Fluid Mechanics = J. Math. Fluid Mech.
Journal of Mathematics and Physics = J. Math. Phys.
Journal of Metamorphic Geology = J. Metamorph. Geol.
Journal of Mineralogical and Petrological Sciences = J. Mineral. Petrol. Sci.
Journal of Mining Science = J. Min. Sci.
Journal of Multiscale Modeling = J. Multiscale Model.
Journal of Nature Conservation = J. Nat. Conserv.
Journal of Navigation = J. Navig.
Journal of Non-Equilibrium Thermodynamics = J. Non-Equilib. Thermodyn.
Journal of Non-Newtonian Fluid Mechanics = J. Non-Newtonian Fluid Mech.
Journal of Nondestructive Evaluation = J. Nondestr. Eval.
Journal of Nonlinear Mathematical Physics = J. Nonlinear Math. Phys.
Journal of Paleolimnology = J. Paleolimnol.
Journal of Paleontology = J. Paleontol.
Journal of Palynology = J. Palynol.
Journal of Peptide Science = J. Pept. Sci.
Journal of Petroleum Geology = J. Pet. Geol
Journal of Petrology = J. Petrol.
Journal of Phase Equilibrium = J. Phase Equilib.
Journal of Phase Equilibrium and Diffusion = J. Phase Equilib. Diffus.
Journal of Physics A: General Physics = J. Phys. A: Gen. Phys.
Journal of Physics A: Mathematical and General = J. Phys. A: Math. Gen.
Journal of Physics A: Mathematical and Theoretical = J. Phys. A: Math. Theor.
Journal of Physics C: Solid State Physics = J. Phys. C: Solid State Phys.
Journal of Physics D: Applied Physics = J. Phys. D: Appl. Phys.
Journal of Physics: Condensed Matter = J. Phys. Condens. Matter
Journal of Physics: Conference Series = J. Phys. Conf. Ser.
Journal of Plasma Physics = J. Plasma Phys.
Journal of Porphyrins and Phthalocyanines = J. Porphyrins Phthalocyanines
Journal of Rheology = J. Rheol.
Journal of Scientific Computing = J. Sci. Comput.
Journal of Sea Research = J. Sea Res.
Journal of Sedimentary Petrology = J. Sediment. Petrol.
Journal of Sedimentary Research = J. Sediment. Res.
Journal of Seismology = J. Seismolog.
Journal of South American Earth Sciences = J. South Amer. Earth Sci.
Journal of Southeast Asian Earth Sciences = J. Southeast Asian Earth Sci.
Journal of Statistical Computation and Simulation = J. Stat. Comput. Simul.
Journal of Statistical Mechanics: Theory and Experiment = J. Stat. Mech: Theory Exp.
Journal of Statistical Physics = J. Stat. Phys.
Journal of Structural Geology = J. Struct. Geol.
Journal of Systematic Palaeontology = J. Syst. Paleontol.
Journal of Terramechanics = J. Terramech.
Journal of Thermophysics and Heat Transfer = J. Thermophys Heat Transfer
Journal of Ultrasound = J. Ultrasound
Journal of Ultrastructure Research = J. Ultrastruct. Res.
Journal of VLSI Signal Processing = J. VLSI Sig. Proc.
Journal of Volcanology and Geothermal Research = J. Volcanol. Geotherm. Res.
Journal of Volcanology and Seismology = J. Volcanol. Seismolog.
Journal of the China University of Geosciences = J. China Univ. Geosci.
Journal of the Franklin Institute = J. Franklin Inst.
Journal of the Geological Society (London, United Kingdom) = J. Geol. Soc. (London, U.K.)
Journal of the Geological Society of Australia = J. Geol. Soc. Aust.
Journal of the Geological Society of Jamaica = J. Geol. Soc. Jam.
Journal of the Geological Society of London = J. Geol. Soc. London
Journal of the Institute of Petroleum = J. Inst. Pet.
Journal of the Mechanics and Physics of Solids = J. Mech. Phys. Solids
Journal of the Physical Society of Japan = J. Phys. Soc. Jpn.
Journal of the Roy Aeronautical Society = J. R. Aeronaut. Soc.
Journal of the Royal Astronomical Society of Canada = J. R. Astron. Soc. Can.
Journal of the Royal Society, Interface = J. R. Soc. Interface
Lecture Notes in Earth Sciences = Lect. Notes Earth Sci.
Lecture Notes in Mathematics = Lect. Notes Math.
Lecture Notes in Physics = Lect. Notes Phys.
Lecture Notes in Physics Monographs = Lect. Notes Phys. Monogr.
Letters in Mathematical Physics = Lett. Math. Phys.
Lithology and Mineral Resources = Lithol. Min. Resour.
Los Alamos National Laboratory, Preprint Archive, Physics = Los Alamos Nat. Lab. Prepr. Arch. Phys.
Marine Geology = Mar. Geol.
Marine Geophysical Researches = Mar. Geophys. Res.
Marine Mining = Mar. Min.
Marine Observer = Mar. Obs.
Marine Structures = Mar. struct.
Marine and Freshwater Research = Mar. Freshwater Res.
Marine and Petroleum Geology = Mar. Pet. Geol.
Mathematical Geology = Math. Geol.
Mathematical Geosciences = Math. Geosci.
Mathematical Models and Methods in Applied Sciences = Math. Models Method Appl. Sci.
Mathematical Physics Analysis and Geometry = Math. Phys. Anal. Geom.
Mathematical Proceedings of the Cambridge Philosophical Society = Math. Proc. Cambridge Philos. Soc.
Mathematics of Computation = Math. Comput.
Mathematicsl Methods in the Applied Sciences = Math. Methods Appl. Sci.
Mathematische Zeitschrift = Math. Z.
Mechanical Systems and Signal Processing = Mech. Syst. Sig. Process.
Mechanics of Solids = Mech. Solids
Memoir - American Association of Petroleum Geologists = Mem. Am. Assoc. Pet. Geol.
Mineralium Deposita = Miner. Deposita
Mineralogical Magazine = Mineral. Mag.
Mineralogy and Petrology = Mineral. Petrol.
Mining Journal = Min. J.
Mining Magazine = Min. Mag.
Mining and Scientific Press = Min. Sci. Press
Modern Physics Letters A = Mod. Phys. Lett. A
Modern Physics Letters B = Mod. Phys. Lett. B
NACTA Journal = NACTA J.
NATO ASI Series, Series A Life Sciences = NATO ASI Ser., Ser. A
NATO ASI Series, Series B Physics = NATO ASI Ser., Ser. B
NATO ASI Series, Series C Mathematical and Physical Sciences = NATO ASI Ser., Ser. C
NATO ASI Series, Series E Applied Physics = NATO ASI Ser., Ser. E
NDT International = NDT Int.
Nature Geoscience = Nat. Geosci.
Nature Physics = Nat. Phys.
Naval Research Logistics = Nav. Res. Logist.
Netherlands Journal of Geosciences = Neth. J. Geosci.
Netherlands Journal of Sea Research = Neth. J. Sea Res.
New Astronomy = New Astron.
New Astronomy Reviews = New Astron. Rev.
New Journal of Physics = New J. Phys.
New Scientist = New Sci.
New Zealand Geological Survey Bulletin = N.Z. Geol. Surv. Bull.
New Zealand Journal of Geology and Geophysics = N.Z. J. Geol. Geophys.
New Zealand Journal of Marine and Freshwater Research = N.Z. J. Mar. Freshwater Res.
New Zealand Journal of Science = N.Z. J. Sci.
New Zealand Journal of Zoology = N.Z. J. Zool.
Non-Destructive Testing = Non-Destr. Test.
Nonlinear Analysis: Hybrid Systems = Nonlinear Anal. Hybrid Syst
Nonlinear Analysis: Real World Applications = Nonlinear Anal. Real World Appl.
Nonlinear Analysis: Theory Methods & Applications = Nonlinear Anal. Theory Methods Appl.
Northwest Science = Northwest Sci.
Norwegian Journal of Geology = Norw. J. Geol.
Numerical Analysis and Applications = Numer. Anal. Appl.
Numerical Heat Transfer Part A = Numer. Heat Transfer, Part A
Numerical Heat Transfer Part B = Numer. Heat Transfer, Part B
Ore Geology Reviews = Ore Geol. Rev.
Paleontological Journal = Paleontolog. J.
Petroleum Geoscience = Pet. Geosci.
Petroleum Science = Pet. Sci.
Petroleum and Coal = Pet. Coal
Phase Transitions = Phase Transitions
Philips Journal of Research = Philips J. Res.
Philosophical Transactions of the Royal Society of London, Series A = Philos. Trans. R. Soc. London, Ser. A
Philosophical Transactions of the Royal Society of London, Series B = Philos. Trans. R. Soc. London, Ser. B
Phosphorus Sulfur Silicon and the Related Elements = Phosphorus, Sulfur Silicon Relat. Elem.
Phosphorus Sulfur and Related Elements = Phosphorus Sulfur Rel. Elem.
Physica A: Statistical Mechanics and its Applications = Physica A
Physica B: Condensed Matter = Physica B
Physica D: Nonlinear Phenomena = Physica D
Physica Scripta = Phys. Scr.
Physica Scripta, T. = Phys. Scr. T.
Physica Status Solidi B Basic Solid State Physics = Phys. Status Solidi B
Physica Status Solidi C Current Topics in Solid State Physics = Phys. Status Solidi C
Physica Status Solidi Rapid Research Letters = Phys. Status Solidi RRL
Physical Mesomechanics = Phys. Mesomech.
Physical Review B: Condensed Matter = Phys. Rev. B: Condens. Matter
Physical Review E: Statistical Physics, Plasmas, Fluids, and Related Interdisciplinary Topics = Phys. Rev. E: Stat. Phys. Plasmas Fluids Relat. Interdisciplin. Top.
Physical Review E: Statistical, Nonlinear, and Soft Matter Physics = Phys. Rev. E: Stat. Nonlinear Soft Matter Phys.
Physical Review Letters = Phys. Rev. Lett.
Physics Letters A = Phys. Lett. A
Physics Letters B = Phys. Lett. B
Physics Teacher = Phys. Teach.
Physics Today = Phys. Today
Physics World = Phys. World
Physics of Atomic Nuclei = Phys. At. Nucl.
Physics of Fluids = Phys. Fluids
Physics of Fluids A = Phys. Fluids A
Physics of Fluids B = Phys. Fluids B
Physics of the Earth and Planetary Interiors = Phys. Earth Planet. In.
Physics of the Solid State = Phys. Solid State
Proceedings in Applied Mathematics and Mechanics = Proc. Appl. Math. Mech.
Proceedings of the Cambridge Philosophical Society = Proc. Cambridge Philos. Soc.
Proceedings of the Combustion Institute = Proc. Combust. Inst.
Proceedings of the Estonian Academy of Sciences = Proc. Est. Acad. Sci.
Proceedings of the Geologists' Association = Proc. Geol. Assoc.
Proceedings of the IEEE = Proc. IEEE
Proceedings of the IRE = Proc. IRE
Proceedings of the International Astronomical Congress = Proc. Int. Astron. Congr.
Proceedings of the International Astronomical Union = Proc. Int. Astron. Union
Proceedings of the National Academy of Sciences of the United States of America = PNAS
Proceedings of the National academy of Sciences of the United States of America = Proc. Nat. Acad. Sci. U.S.A.
Proceedings of the Nutrition Society = Proc. Nutr. Soc.
Proceedings of the Physical Society of London = Proc. Phys. Soc. London
Proceedings of the Physical Society. Section A = Proc. Phys. Soc. London, Sect. A
Proceedings of the Physical Society. Section B = Proc. Phys. Soc. London, Sect. B
Proceedings of the Royal Society of London Series A = Proc. R. Soc. London, Ser. A
Proceedings of the Royal Society of London Series B = Proc. R. Soc. London, Ser. B
Proceedings of the Zoological Society = Proc. Zool. Soc.
Process Safety Progress = Process Saf. Prog.
Progress in Aerospace Sciences = Prog. Aerosp. Sci.
Progress in Histochemistry and Cytochemistry = Prog. Histochem. Cytochem.
Progress in Lipid Research = Prog. Lipid Res.
Progress in Reaction Kinetics = Prog. React. Kinet.
Propellants, Explosives, Pyrotechnics = Propellants Explos. Pyrotech.
Publications of the Astronomical Society of the Pacific = Publ. Astron. Soc. Pac.
Pure and Applied Geophysics = Pure Appl. Geophys.
Pure and Applied Physics = Pure Appl. Phys.
Quarterly Journal of Mechanics and Applied Mathematics = Q. J. Mech. Appl. Math.
Quarterly Journal of Science, Literature, and the Arts = Q. J. Sci. Lit. Arts
Quarterly Journal of Studies on Alcohol = Q. J. Stud. Alcohol
Quarterly Journal of the Geological Society of London = Q. J. Geol. Soc. London
Quarterly Journal of the Royal Astronomical Society = Q. J. R. Astron. Soc.
Quarterly Journal of the Royal Meteorological Society = Q. J. R. Meteorolog. Soc.
Quaternary Geochronology = Quat. Geochronol.
Quaternary International = Quat. Int.
Quaternary Research = Quat. Res.
Quaternary Science Reviews = Quat. Sci. Rev.
Regulatory Peptides = Regul. Pept.
Research in Astronomy and Astrophysics = Res. Astron. Astrophys.
Research in Nondestructive Evaluation = Res. Nondestr. Eval.
Resource Geology = Resour. Geol.
Review of Progress in Coloration and Related Topics = Rev. Prog. Color. Relat. Top.
Reviews in Conservation = Rev. Conserv.
Reviews in Mathematical Physics = Rev. Math. Phys.
Reviews in Mineralogy and Geochemistry = Rev. Mineral. Geochem.
Reviews of Geophysics = Rev. Geophys.
Reviews of Geophysics and Space Physics = Rev. Geophys. Space Phys.
Reviews of Modern Physics = Rev. Mod. Phys.
Rheologica Acta = Rheol. Acta
Rice Science = Rice Sci.
Rocky Mountain Geology = Rocky Mt Geol.
SAMPE Journal = SAMPE J.
Science Foundation in China = Sci. Found. China
Science Progress = Sci. Prog.
Science in China, Series A: Mathematics = Sci. China, Ser. A Math.
Science in China, Series C: Life Sciences = Sci. China, Ser. C Life Sci.
Science in China, Series D: Earth Sciences = Sci. China, Ser. D Earth Sci.
Science in China, Series G: Physics Mechanics and Astronomy = Sci. China, Ser. G
Scientific American = Sci. Am.
Scientific Modeling and Simulation = Sci. Model. Simul.
Sedimentary Geology = Sediment. Geol.
Seismological Research Letters = Seismol. Res. Lett.
Signal Processing = Signal Process.
Solar Physics = Sol. Phys.
Solar System Research = Sol. Syst. Res.
Solid State Ionics = Solid State Ionics
Solid State Sciences = Solid State Sci.
Space Research Today = Space Res. Today
Space Science Reviews = Space Sci. Rev.
Springer Series in Opical Sciences = Springer Ser. Opt. Sci.
Springer Series in Solid-State Sciences = Springer Ser. Solid-State Sci.
Stratigraphy and Geological Correlation = Stratigr. Geol. Correl.
Structural Safety = Struct. Saf.
Structure and Bonding = Struct. Bond.
Studies in Conservation = Stud. Conserv.
Surveys in Geophysics = Surv. Geophys.
Topics in Applied Physics = Top. Appl. Phys.
U.S. Geological Survey Bulletin = U.S. Geol. Surv. Bull.
U.S. Geological Survey Professional Paper = U.S. Geol. Surv. Prof. Pap.
Water Research = Water Res.
Water Resources = Water Resour.
Water Resources Research = Water Resour. Res.
Wiley Interdisciplinary Reviews: Computational Statistics = Wiley Interdiscip. Rev. Comput. Stat.
arXiv.org, e-Print Archive Astrophysics = arXiv.org, e-Print Arch. Astrophys.
arXiv.org, e-Print Archive Condensed Matter = arXiv.org, e-Print Arch. Condens. Matter
arXiv.org, e-Print Archive Physics = arXiv.org, e-Print Arch. Phys.
