Abdominal IMAging=Abdom Imaging;;
Academic Emergency Medicine=Acad Emerg Med;;
Academic Medicine=Acad Med;;
Academic Radiology=Acad Radiol;;
Accident Analysis and Prevention=Accid Anal Prev;;
ACP Journal Club=ACP J Club;;
Acta Anaesthesiologica Belgica=Acta Anaesthesiol Belg;;
Acta Anaesthesiologica Scandinavica=Acta Anaesthesiol Scand;;
Acta Anaesthesiologica Scandinavica. Supplementum=Acta Anaesthesiol Scand Suppl;;
Acta Anatomica=Acta Anat (Basel);;
Acta Biochimica Polonica=Acta Biochim Pol;;
Acta Biologica Hungarica=Acta Biol Hung;;
Acta Bio-Medica de L Ateneo Parmense=Acta Biomed Ateneo Parmense;;
Acta Biotheoretica=Acta Biotheor;;
Acta Cardiologica=Acta Cardiol;;
Acta Chemica Scandinavica=Acta Chem Scand;;
Acta Chirurgiae Plasticae=Acta Chir Plast;;
Acta Chirurgica Belgica=Acta Chir Belg;;
Acta Chirurgica Hungarica=Acta Chir Hung;;
Acta Chirurgica Iugoslavica=Acta Chir Iugosl;;
Acta Cientifica Venezolana=Acta Cient Venez;;
Acta Clinica Belgica=Acta Clin Belg;;
Acta Clinica Belgica. Supplementum=Acta Clin Belg Suppl;;
Acta Crystallographica. Section A, Foundations of Crystallography=Acta Crystallogr A;;
Acta Crystallographica. Section B, Structural Science=Acta Crystallogr B;;
Acta Crystallographica. Section C, Crystal Structure Communications=Acta Crystallogr C;;
Acta Cytologica=Acta Cytol;;
Acta Dermato-Venereologica=Acta Derm Venereol;;
Acta Dermato-Venereologica. Supplementum=Acta Derm Venereol Suppl (Stockh);;
Acta Diabetologica=Acta Diabetol;;
Acta Europaea Fertilitatis=Acta Eur Fertil;;
Acta Gastroenterologica Belgica=Acta Gastroenterol Belg;;
Acta Gastroenterologica Latinoamericana=Acta Gastroenterol Latinoam;;
Acta Geneticae Medicae Et Gemellologiae=Acta Genet Med Gemellol (Roma);;
Acta Haematologica=Acta Haematol;;
Acta Histochemica=Acta Histochem;;
Acta Histochemica. Supplementband=Acta Histochem Suppl;;
Acta Leprologica=Acta Leprol;;
Acta Medica Austriaca=Acta Med Austriaca;;
Acta Medica Croatica=Acta Med Croatica;;
Acta Medica (Hradec Kralove)=Acta Medica (Hradec Kralove);;
Acta Medica (Hradec Kralove). Supplementum=Acta Medica (Hradec Kralove) Suppl;;
Acta Medica Okayama=Acta Med Okayama;;
Acta Medica Portuguesa=Acta Med Port;;
Acta Microbiologica Bulgarica=Acta Microbiol Bulg;;
Acta Microbiologica Et Immunologica Hungarica=Acta Microbiol Immunol Hung;;
Acta Microbiologica Polonica=Acta Microbiol Pol;;
Acta Neurobiologiae Experimentalis=Acta Neurobiol Exp (Warsz);;
Acta Neurochirurgica=Acta Neurochir (Wien);;
Acta Neurochirurgica. Supplementum=Acta Neurochir Suppl (Wien);;
Acta Neurologica Belgica=Acta Neurol Belg;;
Acta Neurologica Scandinavica=Acta Neurol Scand;;
Acta Neurologica Scandinavica. Supplementum=Acta Neurol Scand Suppl;;
Acta Neuropathologica=Acta Neuropathol (Berl);;
Acta Obstetricia Et Gynecologica Scandinavica=Acta Obstet Gynecol Scand;;
Acta Obstetricia Et Gynecologica Scandinavica. Supplement=Acta Obstet Gynecol Scand Suppl;;
Acta Odontologica Scandinavica=Acta Odontol Scand;;
Acta Oncologica=Acta Oncol;;
Acta Ophthalmologica Scandinavica=Acta Ophthalmol Scand;;
Acta Ophthalmologica Scandinavica. Supplement=Acta Ophthalmol Scand Suppl;;
Acta Orthopaedica Belgica=Acta Orthop Belg;;
Acta Orthopaedica Scandinavica=Acta Orthop Scand;;
Acta Orthopaedica Scandinavica. Supplementum=Acta Orthop Scand Suppl;;
Acta Oto-Laryngologica=Acta Otolaryngol (Stockh);;
Acta Oto-Laryngologica. Supplement=Acta Otolaryngol Suppl (Stockh);;
Acta Oto-Rhino-Laryngologica Belgica=Acta Otorhinolaryngol Belg;;
Acta Otorhinolaryngologica Italica=Acta Otorhinolaryngol Ital;;
Acta Otorrinolaringologica Espanola=Acta Otorrinolaringol Esp;;
Acta Paediatrica=Acta Paediatr;;
Acta Paediatrica Japonica=Acta Paediatr Jpn;;
Acta Paediatrica. Supplement=Acta Paediatr Suppl;;
Acta Pharmaceutica Hungarica=Acta Pharm Hung;;
Acta Physiologica Hungarica=Acta Physiol Hung;;
Acta Physiologica Et Pharmacologica Bulgarica=Acta Physiol Pharmacol Bulg;;
Acta Physiologica, Pharmacologica Et Therapeutica Latinoamericana=Acta Physiol Pharmacol Ther Latinoam;;
Acta Physiologica Scandinavica=Acta Physiol Scand;;
Acta Physiologica Scandinavica. Supplementum=Acta Physiol Scand Suppl;;
Acta Poloniae Pharmaceutica=Acta Pol Pharm;;
Acta Psychiatrica Scandinavica=Acta Psychiatr Scand;;
Acta Psychiatrica Scandinavica. Supplementum=Acta Psychiatr Scand Suppl;;
Acta Psychologica=Acta Psychol (Amst);;
Acta Radiologica=Acta Radiol;;
Acta Radiologica. Supplementum=Acta Radiol Suppl;;
Acta Stomatologica Belgica=Acta Stomatol Belg;;
Acta Tropica=Acta Trop;;
Acta Universitatis Carolinae. Medica=Acta Univ Carol [Med] (Praha);;
Acta Universitatis Carolinae. Medica. Monographia=Acta Univ Carol Med Monogr;;
Acta Universitatis Palackianae Olomucensis Facultatis Medicae=Acta Univ Palacki Olomuc Fac Med;;
Acta Urologica Belgica=Acta Urol Belg;;
Acta Veterinaria Hungarica=Acta Vet Hung;;
Acta Veterinaria Scandinavica=Acta Vet Scand;;
Acta Veterinaria Scandinavica. Supplement=Acta Vet Scand Suppl;;
Acta Virologica=Acta Virol;;
Psiquiatria Y Ciencias Afines Actas Luso Esp Neurol Psiquiatr Cien=Afines;;
Actas Urologicas Espanolas=Actas Urol Esp;;
Acupuncture and Electro-Therapeutics Research=Acupunct Electrother Res;;
Addiction=Addiction;;
Addictive Behaviors=Addict Behav;;
Administration and Policy In Mental Health=Adm Policy Ment Health;;
Adolescence=Adolescence;;
Advances In Anatomy, Embryology and Cell Biology=Adv Anat Embryol Cell Biol;;
Advances In Applied Microbiology=Adv Appl Microbiol;;
Advances In Biochemical Engineering/Biotechnology=Adv Biochem Eng Biotechnol;;
Advances In Biochemical Psychopharmacology=Adv Biochem Psychopharmacol;;
Advances In Biophysics=Adv Biophys;;
Advances In Cancer Research=Adv Cancer Res;;
Advances In Carbohydrate Chemistry and Biochemistry=Adv Carbohydr Chem Biochem;;
Advances In Cardiac Surgery=Adv Card Surg;;
Advances In Cardiology=Adv Cardiol;;
Advances In Child Development and Behavior=Adv Child Dev Behav;;
Advances In Chromatography=Adv Chromatogr;;
Advances In Clinical Chemistry=Adv Clin Chem;;
Advances In Colloid and Interface Science=Adv Colloid Interface Sci;;
Advances In Contraception=Adv Contracept;;
Advances In Dermatology=Adv Dermatol;;
Advances In Enzyme Regulation=Adv Enzyme Regul;;
Advances In Enzymology and Related Areas of Molecular Biology=Adv Enzymol Relat Areas Mol Biol;;
Advances In Experimental Medicine and Biology=Adv Exp Med Biol;;
Advances In Food and Nutrition Research=Adv Food Nutr Res;;
Advances In Genetics=Adv Genet;;
Advances In Human Genetics=Adv Hum Genet;;
Advances In Immunology=Adv Immunol;;
Advances In Inorganic Biochemistry=Adv Inorg Biochem;;
Advances In Internal Medicine=Adv Intern Med;;
Advances In Lipid Research=Adv Lipid Res;;
Advances In Microbial Physiology=Adv Microb Physiol;;
Advances In Nephrology From The Necker Hospital=Adv Nephrol Necker Hosp;;
Advances In Neurology=Adv Neurol;;
Advances In Nutritional Research=Adv Nutr Res;;
Advances In Operative Orthopaedics=Adv Oper Orthop;;
Advances In Oto-Rhino-Laryngology=Adv Otorhinolaryngol;;
Advances In Parasitology=Adv Parasitol;;
Advances In Pediatric Infectious Diseases=Adv Pediatr Infect Dis;;
Advances In Pediatrics=Adv Pediatr;;
Advances In Peritoneal Dialysis=Adv Perit Dial;;
Advances In Pharmacology=Adv Pharmacol;;
Advances In Prostaglandin, Thromboxane, and Leukotriene Research=Adv Prostaglandin Thromboxane Leukot Res;;
Advances In Protein Chemistry=Adv Protein Chem;;
Advances In Psychosomatic Medicine=Adv Psychosom Med;;
Advances In Renal Replacement Therapy=Adv Ren Replace Ther;;
Advances In Second Messenger and Phosphoprotein Research=Adv Second Messenger Phosphoprotein Res;;
Advances In Surgery (St. Louis, Mo=Adv Surg;;
Advances and Technical Standards In Neurosurgery=Adv Tech Stand Neurosurg;;
Advances In Veterinary Medicine=Adv Vet Med;;
Advances In Virus Research=Adv Virus Res;;
Adverse Drug Reactions and Toxicological Reviews=Adverse Drug React Toxicol Rev;;
Aesthetic Plastic Surgery=Aesthetic Plast Surg;;
African Journal of Medicine and Medical Sciences=Afr J Med Med Sci;;
Age and Ageing=Age Ageing;;
Agents and Actions. Supplements=Agents Actions Suppl;;
Aging=Aging (Milano);;
AIDS=AIDS;;
AIDS Care=AIDS Care;;
AIDS Clinical Review=AIDS Clin Rev;;
AIDS Education and Prevention=AIDS Educ Prev;;
AIDS Research and Human Retroviruses=AIDS Res Hum Retroviruses;;
AJNR. American Journal of Neuroradiology=AJNR Am J Neuroradiol;;
AJR. American Journal of Roentgenology=AJR Am J Roentgenol;;
Aktuelle Radiologie=Aktuelle Radiol;;
Akusherstvo I Ginekologiia=Akush Ginekol (Sofiia);;
Alaska Medicine=Alaska Med;;
Alcohol=Alcohol;;
Alcohol and Alcoholism=Alcohol Alcohol;;
Alcohol and Alcoholism. Supplement=Alcohol Alcohol Suppl;;
Alcohol Health and Research World=Alcohol Health Res World;;
Alcoholism, Clinical and Experimental Research=Alcohol Clin Exp Res;;
Alimentary Pharmacology and Therapeutics=Aliment Pharmacol Ther;;
Allergie Et Immunologie=Allerg Immunol (Paris);;
Allergologia Et Immunopathologia=Allergol Immunopathol (Madr);;
Allergy=Allergy;;
Allergy and Asthma Proceedings=Allergy Asthma Proc;;
Alternative Therapies In Health and Medicine=Altern Ther Health Med;;
Alzheimer Disease and Associated Disorders=Alzheimer Dis Assoc Disord;;
American Annals of The Deaf=Am Ann Deaf;;
American Family Physician=Am Fam Physician;;
American Heart Journal=Am Heart J;;
American Indian and Alaska Native Mental Health Research=Am Indian Alsk Native Ment Health Res;;
American Indian and Alaska Native Mental Health Research. MonographSeries Am Indian Alsk Native Ment Health Re=Monogr Ser;;
American Industrial Hygiene Association Journal=Am Ind Hyg Assoc J;;
American Journal on Addictions=Am J Addict;;
American Journal of Cardiac IMAging=Am J Card Imaging;;
American Journal of Cardiology=Am J Cardiol;;
American Journal of Cardiovascular Pathology=Am J Cardiovasc Pathol;;
American Journal of Chinese Medicine=Am J Chin Med;;
American Journal of Clinical Hypnosis=Am J Clin Hypn;;
American Journal of Clinical Nutrition=Am J Clin Nutr;;
American Journal of Clinical Oncology=Am J Clin Oncol;;
American Journal of Clinical Pathology=Am J Clin Pathol;;
American Journal of Community Psychology=Am J Community Psychol;;
American Journal of Contact Dermatitis=Am J Contact Dermat;;
American Journal of Critical Care=Am J Crit Care;;
American Journal of Dermatopathology=Am J Dermatopathol;;
American Journal of Drug and Alcohol Abuse=Am J Drug Alcohol Abuse;;
American Journal of Emergency Medicine=Am J Emerg Med;;
American Journal of Epidemiology=Am J Epidemiol;;
American Journal of Forensic Medicine and Pathology=Am J Forensic Med Pathol;;
American Journal of Gastroenterology=Am J Gastroenterol;;
American Journal of Geriatric Psychiatry=Am J Geriatr Psychiatry;;
American Journal of Health-System Pharmacy=Am J Health Syst Pharm;;
American Journal of Hematology=Am J Hematol;;
American Journal of Human Genetics=Am J Hum Genet;;
American Journal of Hypertension=Am J Hypertens;;
American Journal of Industrial Medicine=Am J Ind Med;;
American Journal of Infection Control=Am J Infect Control;;
American Journal of Kidney Diseases=Am J Kidney Dis;;
American Journal of Knee Surgery=Am J Knee Surg;;
American Journal of Law and Medicine=Am J Law Med;;
American Journal of Medical Genetics=Am J Med Genet;;
American Journal of Medical Genetics. Supplement=Am J Med Genet Suppl;;
American Journal of Medical Quality=Am J Med Qual;;
American Journal of The Medical Sciences=Am J Med Sci;;
American Journal of Medicine=Am J Med;;
American Journal of Mental Retardation=Am J Ment Retard;;
American Journal of Nephrology=Am J Nephrol;;
American Journal of Nursing=Am J Nurs;;
American Journal of Obstetrics and Gynecology=Am J Obstet Gynecol;;
American Journal of Occupational Therapy=Am J Occup Ther;;
American Journal of Ophthalmology=Am J Ophthalmol;;
American Journal of Orthodontics and Dentofacial Orthopedics=Am J Orthod Dentofacial Orthop;;
American Journal of Orthopedics=Am J Orthop;;
American Journal of Orthopsychiatry=Am J Orthopsychiatry;;
American Journal of Otolaryngology=Am J Otolaryngol;;
American Journal of Otology=Am J Otol;;
American Journal of Pathology=Am J Pathol;;
American Journal of Perinatology=Am J Perinatol;;
American Journal of Physical Anthropology=Am J Phys Anthropol;;
American Journal of Physical Medicine and Rehabilitation=Am J Phys Med Rehabil;;
American Journal of Physiology=Am J Physiol;;
American Journal of Preventive Medicine=Am J Prev Med;;
American Journal of Primatology=Am J Primatol;;
American Journal of Psychiatry=Am J Psychiatry;;
American Journal of Psychoanalysis=Am J Psychoanal;;
American Journal of Psychology=Am J Psychol;;
American Journal of Psychotherapy=Am J Psychother;;
American Journal of Public Health=Am J Public Health;;
American Journal of Reproductive Immunology=Am J Reprod Immunol;;
American Journal of Respiratory Cell and Molecular Biology=Am J Respir Cell Mol Biol;;
American Journal of Respiratory and Critical Care Medicine=Am J Respir Crit Care Med;;
American Journal of Rhinology=Am J Rhinol;;
American Journal of Sports Medicine=Am J Sports Med;;
American Journal of Surgery=Am J Surg;;
American Journal of Surgical Pathology=Am J Surg Pathol;;
American Journal of Tropical Medicine and Hygiene=Am J Trop Med Hyg;;
American Journal of Veterinary Research=Am J Vet Res;;
American Psychologist=Am Psychol;;
American Surgeon=Am Surg;;
Anaesthesia=Anaesthesia;;
Anaesthesia and Intensive Care=Anaesth Intensive Care;;
Anaesthesiologie Und Reanimation=Anaesthesiol Reanim;;
Anaesthesist=Anaesthesist;;
Anais Da Academia Brasileira de Ciencias=An Acad Bras Cienc;;
Anales Espanoles de Pediatria=An Esp Pediatr;;
Anales de Medicina Interna=An Med Interna;;
Anales Otorrinolaringologicos Iberoamericanos=An Otorrinolaringol Ibero Am;;
Anales de la Real Academia Nacional De Medicina=An R Acad Nac Med (Madr);;
Analyst=Analyst;;
Analytical Biochemistry=Anal Biochem;;
Analytical Cellular Pathology=Anal Cell Pathol;;
Analytical Chemistry=Anal Chem;;
Analytical and Quantitative Cytology And Histology=Anal Quant Cytol Histol;;
Anasthesiologie, Intensivmedizin, Notfallmedizin, SchmerztherapieAnasthesiol Intensivmed Notfallme=Schmerzther;;
Anatomia, Histologia, Embryologia=Anat Histol Embryol;;
Anatomical Record=Anat Rec;;
Anatomischer Anzeiger=Anat Anz;;
Anatomy and Embryology=Anat Embryol (Berl);;
Andrologia=Andrologia;;
Anesteziologiia I Reanimatologiia=Anesteziol Reanimatol;;
Anesthesia and Analgesia=Anesth Analg;;
Anesthesiology=Anesthesiology;;
Angiology=Angiology;;
Angle Orthodontist=Angle Orthod;;
Animal Genetics=Anim Genet;;
Animal Reproduction Science=Anim Reprod Sci;;
Annales Academiae Medicae Stetinensis=Ann Acad Med Stetin;;
Annales de Biologie Clinique=Ann Biol Clin (Paris);;
Annales de Cardiologie Et D Angeiologie=Ann Cardiol Angeiol (Paris);;
Annales Chirurgiae Et Gynaecologiae=Ann Chir Gynaecol;;
Annales Chirurgiae Et Gynaecologiae. Supplementum=Ann Chir Gynaecol Suppl;;
Annales de Chirurgie=Ann Chir;;
Annales de Chirurgie De la Main Et Du Membre Superieur=Ann Chir Main Memb Super;;
Annales de Chirurgie Plastique Et Esthetique=Ann Chir Plast Esthet;;
Annales de Dermatologie Et De Venereologie=Ann Dermatol Venereol;;
Annales D Endocrinologie=Ann Endocrinol (Paris);;
Annales Francaises D Anesthesie Et de Reanimation=Ann Fr Anesth Reanim;;
Annales de Genetique=Ann Genet;;
Annales de Medecine Interne=Ann Med Interne (Paris);;
Annales D Oto-Laryngologie Et de Chirurgie Cervico-Faciale=Ann Otolaryngol Chir Cervicofac;;
Annales de Pathologie=Ann Pathol;;
Annales Pharmaceutiques Francaises=Ann Pharm Fr;;
Annales de Radiologie=Ann Radiol (Paris);;
Annales Universitatis Mariae Curie-Sklodowska. Sectio D, Medicina=Ann Univ Mariae Curie Sklodowska [Med];;
Annales D Urologie=Ann Urol (Paris);;
Annali di Igiene=Ann Ig;;
Annali dell Istituto Superiore di Sanita=Ann Ist Super Sanita;;
Annali Italiani di Chirurgia=Ann Ital Chir;;
Annali Italiani di Medicina Interna=Ann Ital Med Int;;
Annals of The Academy Of Medicine, Singapore=Ann Acad Med Singapore;;
Annals of Allergy, Asthma, and Immunology=Ann Allergy Asthma Immunol;;
Annals of Behavioral Medicine=Ann Behav Med;;
Annals of Biomedical Engineering=Ann Biomed Eng;;
Annals of Clinical Biochemistry=Ann Clin Biochem;;
Annals of Clinical and Laboratory Science=Ann Clin Lab Sci;;
Annals of Clinical Psychiatry=Ann Clin Psychiatry;;
Annals of Dentistry=Ann Dent;;
Annals of Emergency Medicine=Ann Emerg Med;;
Annals of Epidemiology=Ann Epidemiol;;
Annals of Hematology=Ann Hematol;;
Annals of Human Biology=Ann Hum Biol;;
Annals of Human Genetics=Ann Hum Genet;;
Annals of The Icrp=Ann ICRP;;
Annals of Internal Medicine=Ann Intern Med;;
Annals of Medicine=Ann Med;;
Annals of Neurology=Ann Neurol;;
Annals of The New York Academy Of Sciences=Ann N Y Acad Sci;;
Annals of Nuclear Medicine=Ann Nucl Med;;
Annals of Nutrition and Metabolism=Ann Nutr Metab;;
Annals of Occupational Hygiene=Ann Occup Hyg;;
Annals of Oncology=Ann Oncol;;
Annals of Otology, Rhinology and Laryngology=Ann Otol Rhinol Laryngol;;
Annals of Otology, Rhinology, and Laryngology. Supplement=Ann Otol Rhinol Laryngol Suppl;;
Annals of Pharmacotherapy=Ann Pharmacother;;
Annals of Plastic Surgery=Ann Plast Surg;;
Annals of The Rheumatic Diseases=Ann Rheum Dis;;
Annals of The Royal College Of Surgeons Of England=Ann R Coll Surg Engl;;
Annals of Surgery=Ann Surg;;
Annals of Surgical Oncology=Ann Surg Oncol;;
Annals of Thoracic Surgery=Ann Thorac Surg;;
Annals of Tropical Medicine and Parasitology=Ann Trop Med Parasitol;;
Annals of Tropical Paediatrics=Ann Trop Paediatr;;
Annals of Vascular Surgery=Ann Vasc Surg;;
Annual Review of Biochemistry=Annu Rev Biochem;;
Annual Review of Biophysics and Biomolecular Structure=Annu Rev Biophys Biomol Struct;;
Annual Review of Cell and Developmental Biology=Ann Rev Cell Dev Biol;;
Annual Review of Entomology=Annu Rev Entomol;;
Annual Review of Genetics=Annu Rev Genet;;
Annual Review of Immunology=Annu Rev Immunol;;
Annual Review of Medicine=Annu Rev Med;;
Annual Review of Microbiology=Annu Rev Microbiol;;
Annual Review of Neuroscience=Annu Rev Neurosci;;
Annual Review of Nursing Research=Annu Rev Nurs Res;;
Annual Review of Nutrition=Annu Rev Nutr;;
Annual Review of Pharmacology and Toxicology=Annu Rev Pharmacol Toxicol;;
Annual Review of Physical Chemistry=Annu Rev Phys Chem;;
Annual Review of Physiology=Annu Rev Physiol;;
Annual Review of Psychology=Annu Rev Psychol;;
Annual Review of Public Health=Annu Rev Public Health;;
Ans. Advances In Nursing Science=ANS Adv Nurs Sci;;
Anthropologischer Anzeiger=Anthropol Anz;;
Antibiotics and Chemotherapy=Antibiot Chemother;;
Antibiotiki I Khimioterapiia=Antibiot Khimioter;;
Anti-Cancer Drug Design=Anticancer Drug Des;;
Anti-Cancer Drugs=Anticancer Drugs;;
Anticancer Research=Anticancer Res;;
Antimicrobial Agents and Chemotherapy=Antimicrob Agents Chemother;;
Antisense and Nucleic Acid Drug Development=Antisense Nucleic Acid Drug Dev;;
Antiviral Research=Antiviral Res;;
Antonie Van Leeuwenhoek=Antonie Van Leeuwenhoek;;
Aorn Journal=AORN J;;
Apmis=APMIS;;
Apmis. Supplementum=APMIS Suppl;;
Appetite=Appetite;;
Applied Biochemistry and Biotechnology=Appl Biochem Biotechnol;;
Applied and Environmental Microbiology=Appl Environ Microbiol;;
Applied Ergonomics=Appl Ergon;;
Applied Human Science=Appl Human Sci;;
Applied Nursing Research=Appl Nurs Res;;
Applied Psychophysiology and Biofeedback=Appl Psychophysiol Biofeedback;;
Applied Radiation and Isotopes=Appl Radiat Isot;;
Applied and Theoretical Electrophoresis=Appl Theor Electrophor;;
Arbeiten Aus Dem Paul-Ehrlich-Institut (Bundesamt Fur Sera UndImpfstoffe) Zu Frankfurt A.M. Arb Paul Ehrlich Inst Bundesamt Ser=Impfstoffe Frankf A M;;
Archiv Fur Kriminologie=Arch Kriminol;;
Archiv Der Pharmazie=Arch Pharm (Weinheim);;
Archiv Fur Psychologie=Arch Psychol (Frankf);;
Archiv Fur Tierernahrung=Arch Tierernahr;;
Archives D Anatomie Et de Cytologie Pathologiques=Arch Anat Cytol Pathol;;
Archives of Andrology=Arch Androl;;
Archives of Biochemistry and Biophysics=Arch Biochem Biophys;;
Archives of Dermatological Research=Arch Dermatol Res;;
Archives of Dermatology=Arch Dermatol;;
Archives of Disease In Childhood=Arch Dis Child;;
Archives of Disease In Childhood. Fetal and Neonatal Edition=Arch Dis Child Fetal Neonatal Ed;;
Archives of Environmental Contamination and Toxicology=Arch Environ Contam Toxicol;;
Archives of Environmental Health=Arch Environ Health;;
Archives of Family Medicine=Arch Fam Med;;
Archives of General Psychiatry=Arch Gen Psychiatry;;
Archives of Gynecology and Obstetrics=Arch Gynecol Obstet;;
Archives of Histology and Cytology=Arch Histol Cytol;;
Archives of Insect Biochemistry and Physiology=Arch Insect Biochem Physiol;;
Archives de L Institut Pasteur D Algerie=Arch Inst Pasteur Alger;;
Archives de L Institut Pasteur De Madagascar=Arch Inst Pasteur Madagascar;;
Archives de L Institut Pasteur De Tunis=Arch Inst Pasteur Tunis;;
Archives of Internal Medicine=Arch Intern Med;;
Archives Italiennes de Biologie=Arch Ital Biol;;
Archives Des Maladies Du Coeur Et Des Vaisseaux=Arch Mal Coeur Vaiss;;
Archives of Medical Research=Arch Med Res;;
Archives of Microbiology=Arch Microbiol;;
Archives of Neurology=Arch Neurol;;
Archives of Ophthalmology=Arch Ophthalmol;;
Archives of Oral Biology=Arch Oral Biol;;
Archives of Orthopaedic and Trauma Surgery=Arch Orthop Trauma Surg;;
Archives of Otolaryngology -- Head and Neck Surgery=Arch Otolaryngol Head Neck Surg;;
Archives of Pathology and Laboratory Medicine=Arch Pathol Lab Med;;
Archives of Pediatrics and Adolescent Medicine=Arch Pediatr Adolesc Med;;
Archives de Pediatrie=Arch Pediatr;;
Archives of Physical Medicine and Rehabilitation=Arch Phys Med Rehabil;;
Archives of Physiology and Biochemistry=Arch Physiol Biochem;;
Archives of Psychiatric Nursing=Arch Psychiatr Nurs;;
Archives of Sexual Behavior=Arch Sex Behav;;
Archives of Surgery=Arch Surg;;
Archives of Toxicology=Arch Toxicol;;
Archives of Toxicology. Supplement=Arch Toxicol Suppl;;
Archives of Virology=Arch Virol;;
Archives of Virology. Supplementum=Arch Virol Suppl;;
Archivio Italiano di Urologia, Andrologia=Arch Ital Urol Androl;;
Archivos de Bronconeumologia=Arch Bronconeumol;;
Archivos Espanoles de Urologia=Arch Esp Urol;;
Archivos Del Instituto de Cardiologia De Mexico=Arch Inst Cardiol Mex;;
Archivos Latinoamericanos de Nutricion=Arch Latinoam Nutr;;
Archivum Immunologiae Et Therapiae Experimentalis=Arch Immunol Ther Exp (Warsz);;
Arerugi. Japanese Journal of Allergology=Arerugi;;
Arhiv Za Higijenu Rada I Toksikologiju=Arh Hig Rada Toksikol;;
Arkhiv Patologii=Arkh Patol;;
Arquivos Brasileiros de Cardiologia=Arq Bras Cardiol;;
Arquivos de Gastroenterologia=Arq Gastroenterol;;
Arquivos de Neuro-Psiquiatria=Arq Neuropsiquiatr;;
Arteriosclerosis, Thrombosis, and Vascular Biology=Arterioscler Thromb Vasc Biol;;
Artery=Artery;;
Arthritis and Rheumatism=Arthritis Rheum;;
Arthroscopy=Arthroscopy;;
Artificial Cells, Blood Substitutes, and Immobilization BiotechnologyArtif Cells Blood Substit Immobi=Biotechnol;;
Artificial Intelligence In Medicine=Artif Intell Med;;
Artificial Life=Artif Life;;
Artificial Organs=Artif Organs;;
Arzneimittel-Forschung=Arzneimittelforschung;;
Asaio Journal=ASAIO J;;
Asdc Journal of Dentistry For Children=ASDC J Dent Child;;
ASHA=ASHA;;
ASHA. Supplement=ASHA Suppl;;
Asian Pacific Journal of Allergy and Immunology=Asian Pac J Allergy Immunol;;
Asia-Pacific Journal of Public Health=Asia Pac J Public Health;;
Atencion Primaria=Aten Primaria;;
Atherosclerosis=Atherosclerosis;;
Audiology=Audiology;;
Audiology and Neuro-Otology=Audiol Neurootol;;
Auris, Nasus, Larynx=Auris Nasus Larynx;;
Australasian Journal of Dermatology=Australas J Dermatol;;
Australasian Physical and Engineering Sciences In Medicine=Australas Phys Eng Sci Med;;
Australasian Radiology=Australas Radiol;;
Australian Dental Journal=Aust Dent J;;
Australian Family Physician=Aust Fam Physician;;
Australian Journal of Science and Medicine In Sport=Aust J Sci Med Sport;;
Australian and New Zealand Journal of Medicine=Aust N Z J Med;;
Australian and New Zealand Journal of Obstetrics And Gynaecology=Aust N Z J Obstet Gynaecol;;
Australian and New Zealand Journal of Ophthalmology=Aust N Z J Ophthalmol;;
Australian and New Zealand Journal of Psychiatry=Aust N Z J Psychiatry;;
Australian and New Zealand Journal of Public Health=Aust N Z J Public Health;;
Australian and New Zealand Journal of Surgery=Aust N Z J Surg;;
Australian Veterinary Journal=Aust Vet J;;
Autoimmunity (Yverdon-Les-Bains=Autoimmunity;;
Aviakosmicheskaia I Ekologicheskaia Meditsina=Aviakosm Ekolog Med;;
Avian Diseases=Avian Dis;;
Aviation Space and Environmental Medicine=Aviat Space Environ Med;;
Baillieres Clinical Endocrinology and Metabolism=Baillieres Clin Endocrinol Metab;;
Baillieres Clinical Gastroenterology=Baillieres Clin Gastroenterol;;
Baillieres Clinical Haematology=Baillieres Clin Haematol;;
Baillieres Clinical Neurology=Baillieres Clin Neurol;;
Baillieres Clinical Obstetrics and Gynaecology=Baillieres Clin Obstet Gynaecol;;
Baillieres Clinical Rheumatology=Baillieres Clin Rheumatol;;
Bangladesh Medical Research Council Bulletin=Bangladesh Med Res Counc Bull;;
Basic Life Sciences=Basic Life Sci;;
Basic Research In Cardiology=Basic Res Cardiol;;
Behavior Genetics=Behav Genet;;
Behavior Modification=Behav Modif;;
Behavioral and Brain Sciences=Behav Brain Sci;;
Behavioral Medicine=Behav Med;;
Behavioral Neuroscience=Behav Neurosci;;
Behavioral Sciences and The Law=Behav Sci Law;;
Behaviour Research and Therapy=Behav Res Ther;;
Behavioural Brain Research=Behav Brain Res;;
Behavioural Pharmacology=Behav Pharmacol;;
Behring Institute Mitteilungen (Marburg/Lahn=Behring Inst Mitt;;
Beitrage Zur Gerichtlichen Medizin=Beitr Gerichtl Med;;
Beitrage Zur Infusionstherapie Und Transfusionsmedizin=Beitr Infusionsther Transfusionsmed;;
Berliner Und Munchener Tierarztliche Wochenschrift=Berl Munch Tierarztl Wochenschr;;
Bibliotheca Nutritio Et Dieta=Bibl Nutr Dieta;;
Biocell=Biocell;;
Biochemical and Biophysical Research Communications=Biochem Biophys Res Commun;;
Biochemical Genetics=Biochem Genet;;
Biochemical Journal=Biochem J;;
Biochemical Pharmacology=Biochem Pharmacol;;
Biochemical Society Symposia=Biochem Soc Symp;;
Biochemical Society Transactions=Biochem Soc Trans;;
Biochemistry=Biochemistry;;
Biochemistry=Biochemistry (Mosc);;
Biochemistry and Cell Biology=Biochem Cell Biol;;
Biochemistry and Molecular Biology International=Biochem Mol Biol Int;;
Biochimica Et Biophysica Acta=Biochim Biophys Acta;;
Biochimie=Biochimie;;
Bioconjugate Chemistry=Bioconjug Chem;;
Bioelectromagnetics=Bioelectromagnetics;;
Bioessays=Bioessays;;
Biofactors=Biofactors;;
Biofizika=Biofizika;;
Bioinformatics=Bioinformatics;;
Biological Bulletin=Biol Bull;;
Biological Chemistry=Biol Chem;;
Biological Cybernetics=Biol Cybern;;
Biological and Pharmaceutical Bulletin=Biol Pharm Bull;;
Biological Psychiatry=Biol Psychiatry;;
Biological Psychology=Biol Psychol;;
Biological Research=Biol Res;;
Biological Reviews of The Cambridge Philosophical Society=Biol Rev Camb Philos Soc;;
Biological Signals=Biol Signals;;
Biological Trace Element Research=Biol Trace Elem Res;;
Biologicals=Biologicals;;
Biology of Blood and Marrow Transplantation=Biol Blood Marrow Transplant;;
Biology of The Cell=Biol Cell;;
Biology of The Neonate=Biol Neonate;;
Biology of Reproduction=Biol Reprod;;
Biomaterials=Biomaterials;;
Biomedical Chromatography=Biomed Chromatogr;;
Biomedical and Environmental Sciences=Biomed Environ Sci;;
Biomedical Instrumentation and Technology=Biomed Instrum Technol;;
Bio-Medical Materials and Engineering=Biomed Mater Eng;;
Biomedical Peptides, Proteins and Nucleic Acids=Biomed Pept Proteins Nucleic Acids;;
Biomedical Sciences Instrumentation=Biomed Sci Instrum;;
Biomedicine and Pharmacotherapy=Biomed Pharmacother;;
Biomedizinische Technik=Biomed Tech (Berl);;
Biometals=Biometals;;
Biometrics=Biometrics;;
Bioorganic and Medicinal Chemistry=Bioorg Med Chem;;
Bioorganicheskaia Khimiia=Bioorg Khim;;
Biopharmaceutics and Drug Disposition=Biopharm Drug Dispos;;
Biophysical Chemistry=Biophys Chem;;
Biophysical Journal=Biophys J;;
Biopolymers=Biopolymers;;
Biorheology=Biorheology;;
Bioscience Reports=Biosci Rep;;
Biosensors and Bioelectronics=Biosens Bioelectron;;
Biosystems=Biosystems;;
Biotechnic and Histochemistry=Biotech Histochem;;
Biotechniques=Biotechniques;;
Biotechnology=Biotechnology;;
Biotechnology and Applied Biochemistry=Biotechnol Appl Biochem;;
Biotechnology and Genetic Engineering Reviews=Biotechnol Genet Eng Rev;;
Biotherapy=Biotherapy;;
Biulleten Eksperimentalnoi Biologii I Meditsiny=Biull Eksp Biol Med;;
BJR Supplement=BJR Suppl;;
Blood=Blood;;
Blood Cells, Molecules, and Diseases=Blood Cells Mol Dis;;
Blood Coagulation and Fibrinolysis=Blood Coagul Fibrinolysis;;
Blood Pressure=Blood Press;;
Blood Pressure. Supplement=Blood Press Suppl;;
Blood Purification=Blood Purif;;
Blood Reviews=Blood Rev;;
BMJ (Clinical Research Ed.)=BMJ;;
Boletin - Asociacion Medica de Puerto Rico=Bol Asoc Med P R;;
Boletin Chileno de Parasitologia=Bol Chil Parasitol;;
Boletin de Estudios Medicos Y Biologicos=Bol Estud Med Biol;;
Bollettino Chimico Farmaceutico=Boll Chim Farm;;
Bollettino - Societa Italiana Biologia Sperimentale=Boll Soc Ital Biol Sper;;
Bone=Bone;;
Bone Marrow Transplantation=Bone Marrow Transplant;;
Brain=Brain;;
Brain, Behavior and Evolution=Brain Behav Evol;;
Brain, Behavior, and Immunity=Brain Behav Immun;;
Brain and Cognition=Brain Cogn;;
Brain and Development=Brain Dev;;
Brain Injury=Brain Inj;;
Brain and Language=Brain Lang;;
Brain Pathology=Brain Pathol;;
Brain Research=Brain Res;;
Brain Research. Brain Research Protocols=Brain Res Brain Res Protoc;;
Brain Research. Brain Research Reviews=Brain Res Brain Res Rev;;
Brain Research Bulletin=Brain Res Bull;;
Brain Research. Cognitive Brain Research=Brain Res Cogn Brain Res;;
Brain Research. Developmental Brain Research=Brain Res Dev Brain Res;;
Brain Research. Molecular Brain Research=Brain Res Mol Brain Res;;
Brain Topography=Brain Topogr;;
Brain Tumor Pathology=Brain Tumor Pathol;;
Bratislavske Lekarske Listy=Bratisl Lek Listy;;
Brazilian Journal of Medical and Biological Research=Braz J Med Biol Res;;
Breast Cancer Research and Treatment=Breast Cancer Res Treat;;
British Dental Journal=Br Dent J;;
British Journal of Anaesthesia=Br J Anaesth;;
British Journal of Audiology=Br J Audiol;;
British Journal of Biomedical Science=Br J Biomed Sci;;
British Journal of Cancer=Br J Cancer;;
British Journal of Clinical Pharmacology=Br J Clin Pharmacol;;
British Journal of Clinical Psychology=Br J Clin Psychol;;
British Journal of Dermatology=Br J Dermatol;;
British Journal of Educational Psychology=Br J Educ Psychol;;
British Journal of General Practice=Br J Gen Pract;;
British Journal of Haematology=Br J Haematol;;
British Journal of Hospital Medicine=Br J Hosp Med;;
British Journal of Mathematical and Statistical Psychology=Br J Math Stat Psychol;;
British Journal of Medical Psychology=Br J Med Psychol;;
British Journal of Neurosurgery=Br J Neurosurg;;
British Journal of Nutrition=Br J Nutr;;
British Journal of Obstetrics and Gynaecology=Br J Obstet Gynaecol;;
British Journal of Ophthalmology=Br J Ophthalmol;;
British Journal of Oral and Maxillofacial Surgery=Br J Oral Maxillofac Surg;;
British Journal of Orthodontics=Br J Orthod;;
British Journal of Pharmacology=Br J Pharmacol;;
British Journal of Plastic Surgery=Br J Plast Surg;;
British Journal of Psychiatry=Br J Psychiatry;;
British Journal of Psychiatry. Supplement=Br J Psychiatry Suppl;;
British Journal of Psychology=Br J Psychol;;
British Journal of Radiology=Br J Radiol;;
British Journal of Rheumatology=Br J Rheumatol;;
British Journal of Social Psychology=Br J Soc Psychol;;
British Journal of Sociology=Br J Sociol;;
British Journal of Sports Medicine=Br J Sports Med;;
British Journal of Surgery=Br J Surg;;
British Journal of Urology=Br J Urol;;
British Medical Bulletin=Br Med Bull;;
British Poultry Science=Br Poult Sci;;
Bulletin de L Academie Nationale De Medecine=Bull Acad Natl Med;;
Bulletin de L Association Des Anatomistes=Bull Assoc Anat (Nancy);;
Bulletin Du Cancer=Bull Cancer;;
Bulletin of Environmental Contamination and Toxicology=Bull Environ Contam Toxicol;;
Bulletin Du Groupement International Pour la Recherche Scientifique En Stomatologie Et Odontologie=Bull Group Int Rech Sci Stomatol Odontol;;
Bulletin of The History Of Medicine=Bull Hist Med;;
Bulletin / Hospital For Joint Diseases=Bull Hosp Jt Dis;;
Bulletin of The Institute Of Maritime and Tropical Medicine In Gdynia=Bull Inst Marit Trop Med Gdynia;;
Bulletin of Mathematical Biology=Bull Math Biol;;
Bulletin of The Medical Library Association=Bull Med Libr Assoc;;
Bulletin Et Memoires de L Academie Royale De Medecine De Belgique=Bull Mem Acad R Med Belg;;
Bulletin of The Menninger Clinic=Bull Menninger Clin;;
Bulletin on Narcotics=Bull Narc;;
Bulletin of The New York Academy Of Medicine=Bull N Y Acad Med;;
Bulletin on The Rheumatic Diseases=Bull Rheum Dis;;
Bulletin de la Societe Belge D Ophtalmologie=Bull Soc Belge Ophtalmol;;
Bulletin de la Societe Des Sciences Medicales Du Grand-Duche De Luxembourg=Bull Soc Sci Med Grand Duche Luxemb;;
Bulletin of The World Health Organization=Bull World Health Organ;;
Burns=Burns;;
CA: A Cancer Journal For Clinicians=CA Cancer J Clin;;
Caduceus=Caduceus;;
Cahiers D Anesthesiologie=Cah Anesthesiol;;
Cahiers de Sociologie Et De Demographie Medicales=Cah Sociol Demogr Med;;
Calcified Tissue International=Calcif Tissue Int;;
Cambridge Quarterly of Healthcare Ethics=Camb Q Healthc Ethics;;
Canada Communicable Disease Report=Can Commun Dis Rep;;
Canadian Association of Radiologists Journal=Can Assoc Radiol J;;
Canadian Family Physician=Can Fam Physician;;
Canadian Journal of Anaesthesia=Can J Anaesth;;
Canadian Journal of Applied Physiology=Can J Appl Physiol;;
Canadian Journal of Cardiology=Can J Cardiol;;
Canadian Journal of Experimental Psychology=Can J Exp Psychol;;
Canadian Journal of Gastroenterology=Can J Gastroenterol;;
Canadian Journal of Microbiology=Can J Microbiol;;
Canadian Journal of Neurological Sciences=Can J Neurol Sci;;
Canadian Journal of Oncology=Can J Oncol;;
Canadian Journal of Ophthalmology=Can J Ophthalmol;;
Canadian Journal of Physiology and Pharmacology=Can J Physiol Pharmacol;;
Canadian Journal of Psychiatry. Revue Canadienne de Psychiatrie=Can J Psychiatry;;
Canadian Journal of Public Health. Revue Canadienne de Sante Publique=Can J Public Health;;
Canadian Journal of Surgery=Can J Surg;;
Canadian Journal of Veterinary Research=Can J Vet Res;;
Canadian Veterinary Journal=Can Vet J;;
Cancer=Cancer;;
Cancer Biochemistry Biophysics=Cancer Biochem Biophys;;
Cancer Causes and Control=Cancer Causes Control;;
Cancer Chemotherapy and Biological Response Modifiers=Cancer Chemother Biol Response Modif;;
Cancer Chemotherapy and Pharmacology=Cancer Chemother Pharmacol;;
Cancer Detection and Prevention=Cancer Detect Prev;;
Cancer Epidemiology, Biomarkers and Prevention=Cancer Epidemiol Biomarkers Prev;;
Cancer Gene Therapy=Cancer Gene Ther;;
Cancer Genetics and Cytogenetics=Cancer Genet Cytogenet;;
Cancer Immunology, Immunotherapy=Cancer Immunol Immunother;;
Cancer Investigation=Cancer Invest;;
Cancer Journal From Scientific American=Cancer J Sci Am;;
Cancer Letters=Cancer Lett;;
Cancer and Metastasis Reviews=Cancer Metastasis Rev;;
Cancer Nursing=Cancer Nurs;;
Cancer Radiotherapie=Cancer Radiother;;
Cancer Research=Cancer Res;;
Cancer Surveys=Cancer Surv;;
Cancer Treatment and Research=Cancer Treat Res;;
Cancer Treatment Reviews=Cancer Treat Rev;;
Carbohydrate Research=Carbohydr Res;;
Carcinogenesis=Carcinogenesis;;
Carcinogenesis; A Comprehensive Survey=Carcinog Compr Surv;;
Cardiologia=Cardiologia;;
Cardiology=Cardiology;;
Cardiology Clinics=Cardiol Clin;;
Cardiovascular Drugs and Therapy=Cardiovasc Drugs Ther;;
Cardiovascular and Interventional Radiology=Cardiovasc Intervent Radiol;;
Cardiovascular Research=Cardiovasc Res;;
Cardiovascular Surgery=Cardiovasc Surg;;
Caries Research=Caries Res;;
Casopis Lekaru Ceskych=Cas Lek Cesk;;
Catheterization and Cardiovascular Diagnosis=Cathet Cardiovasc Diagn;;
Cell=Cell;;
Cell Adhesion and Communication=Cell Adhes Commun;;
Cell Biochemistry and Biophysics=Cell Biochem Biophys;;
Cell Biochemistry and Function=Cell Biochem Funct;;
Cell Biology International=Cell Biol Int;;
Cell Biology and Toxicology=Cell Biol Toxicol;;
Cell Calcium=Cell Calcium;;
Cell Growth and Differentiation=Cell Growth Differ;;
Cell Motility and The Cytoskeleton=Cell Motil Cytoskeleton;;
Cell Proliferation=Cell Prolif;;
Cell Research=Cell Res;;
Cell Stress and Chaperones=Cell Stress Chaperones;;
Cell Structure and Function=Cell Struct Funct;;
Cell and Tissue Research=Cell Tissue Res;;
Cell Transplantation=Cell Transplant;;
Cellular Immunology=Cell Immunol;;
Cellular and Molecular Life Sciences=Cell Mol Life Sci;;
Cellular and Molecular Neurobiology=Cell Mol Neurobiol;;
Cellular Signalling=Cell Signal;;
Central African Journal of Medicine=Cent Afr J Med;;
Central European Journal of Public Health=Cent Eur J Public Health;;
Cephalalgia=Cephalalgia;;
Cerebral Cortex=Cereb Cortex;;
Ceska A Slovenska Farmacie=Ceska Slov Farm;;
Ceska A Slovenska Oftalmologie=Cesk Slov Oftalmol;;
Ceska Gynekologie=Ceska Gynekol;;
Ceskoslovenska Fysiologie=Cesk Fysiol;;
Ceskoslovenska Patologie=Cesk Patol;;
Ceylon Medical Journal=Ceylon Med J;;
Chang Keng I Hsueh Chang Gung Medical Journal=Chang Keng I Hsueh;;
Chemical Immunology=Chem Immunol;;
Chemical and Pharmaceutical Bulletin=Chem Pharm Bull (Tokyo);;
Chemical Research In Toxicology=Chem Res Toxicol;;
Chemical Senses=Chem Senses;;
Chemico-Biological Interactions=Chem Biol Interact;;
Chemistry and Biology=Chem Biol;;
Chemistry and Physics of Lipids=Chem Phys Lipids;;
Chemosphere=Chemosphere;;
Chemotherapy=Chemotherapy;;
Chen Tzu Yen Chiu Acupuncture Research=Chen Tzu Yen Chiu;;
Chest=Chest;;
Chest Surgery Clinics of North America=Chest Surg Clin N Am;;
Child Abuse and Neglect=Child Abuse Negl;;
Child and Adolescent Psychiatric Clinics of North America=Child Adolesc Psychiatr Clin N Am;;
Child: Care, Health and Development=Child Care Health Dev;;
Child Development=Child Dev;;
Child Psychiatry and Human Development=Child Psychiatry Hum Dev;;
Child Welfare=Child Welfare;;
Childs Nervous System=Childs Nerv Syst;;
Chinese Journal of Biotechnology=Chin J Biotechnol;;
Chinese Journal of Physiology=Chin J Physiol;;
Chinese Medical Journal=Chin Med J (Engl);;
Chinese Medical Sciences Journal=Chin Med Sci J;;
Chirality=Chirality;;
Chirurg=Chirurg;;
Chirurgia=Chirurgia (Bucur);;
Chirurgia Italiana=Chir Ital;;
Chirurgia Maxillofacialis Et Plastica=Chir Maxillofac Plast;;
Chirurgia Narzadow Ruchu I Ortopedia Polska=Chir Narzadow Ruchu Ortop Pol;;
Chirurgia Degli Organi di Movimento=Chir Organi Mov;;
Chirurgie=Chirurgie;;
Chromosoma=Chromosoma;;
Chromosome Research=Chromosome Res;;
Chronic Diseases In Canada=Chronic Dis Can;;
Chronobiology International=Chronobiol Int;;
Chung Yao Tsai Journal of Chinese Medicinal Materials (Kuang-Chou Shih=Chung Yao Tsai;;
Chung-Hua Cheng Hsing Shao Shang Wai Ko Tsa Chih [Chinese Journal OfPlastic Surgery and Burns] Chung Hua Cheng Hsing Shao Shang Wai Ko Ts=Chih;;
Chung-Hua Chieh Ho Ho Hu Hsi Tsa Chih Chinese Journal of Tuberculosis and Respiratory Diseases=Chung Hua Chieh Ho Ho Hu Hsi Tsa Chih;;
Chung-Hua Chung Liu Tsa Chih [Chinese Journal of Oncology]=Chung Hua Chung Liu Tsa Chih;;
Chung-Hua Erh Pi Yen Hou Ko Tsa Chih Chinese Journal Of Otorhinolaryngology=Chung Hua Erh Pi Yen Hou Ko Tsa Chih;;
Chung-Hua Fu Chan Ko Tsa Chih [Chinese Journal of Obstetrics AndGynecology]=Chung Hua Fu Chan Ko Tsa Chih;;
Chung-Hua Hsueh Yeh Hsueh Tsa Chih Chinese Journal of Hematology=Chung Hua Hsueh Yeh Hsueh Tsa Chi;;
Chung-Hua I Hsueh Tsa Chih [Chinese Medical Journal]=Chung Hua I Hsueh Tsa Chih;;
Chung-Hua I Hsueh Tsa Chih [Chinese Medical Journal]=Chung Hua I Hsueh Tsa Chih (Taipei);;
Chung-Hua Kou Chiang I Hsueh Tsa Chih Chinese Journal of Stomatology=Chung Hua Kou Chiang Hsueh Tsa Chih;;
Chung-Hua Liu Hsing Ping Hsueh Tsa Chih Chinese Journal of Epidemiology (Pei-Ching=Chung Hua Liu Hsing Ping Hsueh Tsa Chih;;
Chung-Hua Min Kuo Hsiao Erh Ko I Hsueh Hui Tsa Chih Chung Hua Min KuoHsiao Erh Ko I Hsueh Hu=Tsa Chih;;
Chung-Hua Min Kuo Wei Sheng Wu Chi Mien I Hsueh Tsa Chih Chinese JournalOf Microbiology and Immunology Chung Hua Min Kuo Wei Sheng Wu Chi Mien=Hsueh Tsa Chih;;
Chung-Hua Nei Ko Tsa Chih Chinese Journal of Internal Medicine=Chung Hua Nei Ko Tsa Chih;;
Chung-Hua Ping Li Hsueh Tsa Chih [Chinese Journal of Pathology]=Chung Hua Ping Li Hsueh Tsa Chih;;
Chung-Hua Shih Yen Ho Lin Chuang Ping Tu Hsueh Tsa Chih ChineseJournal of Experimental and Clinical Virology Chung Hua Shih Yen Ho
Lin Chuang Ping T=Hsueh Tsa Chih;;
Chung-Hua Wai Ko Tsa Chih [Chinese Journal of Surgery]=Chung Hua Wai Ko Tsa Chih;;
Chung-Hua Yen Ko Tsa Chih [Chinese Journal of Ophthalmology]=Chung Hua Yen Ko Tsa Chih;;
Chung-Hua Yu Fang I Hsueh Tsa Chih [Chinese Journal Of Preventive Medicine]=Chung Hua Yu Fang I Hsueh Tsa Chih;;
Chung-Kuo Chi Sheng Chung Hsueh Yu Chi Sheng Chung Ping Tsa Chih ChineseJournal of Parasitology and Parasitic Diseases Chung Kuo Chi Sheng Chung
Hsueh Yu Ch=Sheng Chung Ping Tsa Chih;;
Chung-Kuo Chung Hsi I Chieh Ho Tsa Chih (Pei-Ching=Chung Kuo Chung Hsi I Chieh Ho Tsa Chih;;
Chung-Kuo Chung Yao Tsa Chih China Journal of Chinese Materia Medica (Pei-Ching=Chung Kuo Chung Yao Tsa Chih;;
Chung-Kuo Hsiu Fu Chung Chien Wai Ko Tsa Chih Chinesse Journal OfReparative and Reconstructive Surgery (Cheng-Tu Shih) Chung Kuo Hsiu Fu
Chung Chien Wai Ko Ts=Chih;;
Chung-Kuo I Hsueh Ko Hsueh Yuan Hsueh Pao Acta Academiae Medicinae Sinicae=Chung Kuo I Hsueh Ko Hsueh Yuan Hsueh Pao;;
Chung-Kuo I Liao Chi Hsieh Tsa Chih Chinese Journal of Medical Instrumentation (Shang-Hai Shih=Chung Kuo I Liao Chi Hsieh Tsa Chih;;
Chung-Kuo Yao Li Hsueh Pao [Acta Pharmacologica Sinica]=Chung Kuo Yao Li Hsueh Pao;;
Chung-Kuo Ying Yung Sheng Li Hsueh Tsa Chih Chinese Journal of Applied Physiology=Chung Kuo Ying Yung Sheng Li Hsueh Tsa Chih;;
Ciba Foundation Symposium=Ciba Found Symp;;
Circulation=Circulation;;
Circulation Research=Circ Res;;
Cirugia Pediatrica=Cir Pediatr;;
CLAO Journal=CLAO J;;
Cleft Palate-Craniofacial Journal=Cleft Palate Craniofac J;;
Cleveland Clinic Journal of Medicine=Cleve Clin J Med;;
Clinica Chimica Acta=Clin Chim Acta;;
Clinica Terapeutica=Clin Ter;;
Clinical Anatomy=Clin Anat;;
Clinical Autonomic Research=Clin Auton Res;;
Clinical Biochemistry=Clin Biochem;;
Clinical Cardiology=Clin Cardiol;;
Clinical Chemistry=Clin Chem;;
Clinical Chemistry and Laboratory Medicine=Clin Chem Lab Med;;
Clinical and Diagnostic Laboratory Immunology=Clin Diagn Lab Immunol;;
Clinical Dysmorphology=Clin Dysmorphol;;
Clinical Electroencephalography=Clin Electroencephalogr;;
Clinical Endocrinology=Clin Endocrinol (Oxf);;
Clinical and Experimental Allergy=Clin Exp Allergy;;
Clinical and Experimental Dermatology=Clin Exp Dermatol;;
Clinical and Experimental Hypertension=Clin Exp Hypertens;;
Clinical and Experimental Immunology=Clin Exp Immunol;;
Clinical and Experimental Metastasis=Clin Exp Metastasis;;
Clinical and Experimental Obstetrics And Gynecology=Clin Exp Obstet Gynecol;;
Clinical and Experimental Pharmacology And Physiology=Clin Exp Pharmacol Physiol;;
Clinical and Experimental Pharmacology And Physiology. Supplement=Clin Exp Pharmacol Physiol Suppl;;
Clinical and Experimental Rheumatology=Clin Exp Rheumatol;;
Clinical Genetics=Clin Genet;;
Clinical Hemorheology and Microcirculation=Clin Hemorheol Microcirc;;
Clinical IMAging=Clin Imaging;;
Clinical Immunology and Immunopathology=Clin Immunol Immunopathol;;
Clinical Infectious Diseases=Clin Infect Dis;;
Clinical and Investigative Medicine. Medecine Clinique Et Experimentale=Clin Invest Med;;
Clinical Journal of Pain=Clin J Pain;;
Clinical Journal of Sport Medicine=Clin J Sport Med;;
Clinical and Laboratory Haematology=Clin Lab Haematol;;
Clinical Microbiology Reviews=Clin Microbiol Rev;;
Clinical Nephrology=Clin Nephrol;;
Clinical Neurology and Neurosurgery=Clin Neurol Neurosurg;;
Clinical Neuropathology=Clin Neuropathol;;
Clinical Neuropharmacology=Clin Neuropharmacol;;
Clinical Neuroscience=Clin Neurosci;;
Clinical Neurosurgery=Clin Neurosurg;;
Clinical Nuclear Medicine=Clin Nucl Med;;
Clinical Obstetrics and Gynecology=Clin Obstet Gynecol;;
Clinical Oncology (Royal College of Radiologists)=Clin Oncol (R Coll Radiol);;
Clinical Orthopaedics and Related Research=Clin Orthop;;
Clinical Otolaryngology=Clin Otolaryngol;;
Clinical Pediatrics=Clin Pediatr (Phila);;
Clinical Pharmacokinetics=Clin Pharmacokinet;;
Clinical Pharmacology and Therapeutics=Clin Pharmacol Ther;;
Clinical Physiology=Clin Physiol;;
Clinical Psychology Review=Clin Psychol Rev;;
Clinical Radiology=Clin Radiol;;
Clinical Rehabilitation=Clin Rehabil;;
Clinical Reviews In Allergy and Immunology=Clin Rev Allergy Immunol;;
Clinical Rheumatology=Clin Rheumatol;;
Clinical Science=Clin Sci (Colch);;
Clinical Symposia=Clin Symp;;
Clinical Techniques In Small Animal Practice=Clin Tech Small Anim Pract;;
Clinical Therapeutics=Clin Ther;;
Clinical Transplantation=Clin Transplant;;
Clinical Transplants=Clin Transpl;;
Clinics In Chest Medicine=Clin Chest Med;;
Clinics In Dermatology=Clin Dermatol;;
Clinics In Diagnostic Ultrasound=Clin Diagn Ultrasound;;
Clinics In Geriatric Medicine=Clin Geriatr Med;;
Clinics In Laboratory Medicine=Clin Lab Med;;
Clinics In Perinatology=Clin Perinatol;;
Clinics In Plastic Surgery=Clin Plast Surg;;
Clinics In Podiatric Medicine and Surgery=Clin Podiatr Med Surg;;
Clinics In Sports Medicine=Clin Sports Med;;
Clio Medica=Clio Med;;
CMAJ=CMAJ;;
Cognitive Computation = Cognit. Comput.
Cold Spring Harbor Symposia on Quantitative Biology=Cold Spring Harb Symp Quant Biol;;
Collegium Antropologicum=Coll Antropol;;
Communicable Disease Report. CDR Review=Commun Dis Rep CDR Rev;;
Communicable Disease Report. CDR Supplement=Commun Dis Rep CDR Suppl;;
Communicable Disease Report. CDR Weekly=Commun Dis Rep CDR Wkly;;
Communicable Diseases Intelligence=Commun Dis Intell;;
Community Dental Health (Houndsmills, Hampshire=Community Dent Health;;
Community Dentistry and Oral Epidemiology=Community Dent Oral Epidemiol;;
Community Mental Health Journal=Community Ment Health J;;
Comparative Immunology, Microbiology and Infectious Diseases=Comp Immunol Microbiol Infect Dis;;
Comprehensive Psychiatry=Compr Psychiatry;;
Comprehensive Therapy=Compr Ther;;
Comptes Rendus de L Academie Des Sciences. Serie III, Sciences De La Vie=C R Acad Sci III;;
Comptes Rendus Des Seances de la Societe De Biologie Et De Ses Filiales=C R Seances Soc Biol Fil;;
Computer Aided Surgery=Comput Aided Surg;;
Computer Methods and Programs In Biomedicine=Comput Methods Programs Biomed;;
Computerized Medical IMAging and Graphics=Comput Med Imaging Graph;;
Computers In Biology and Medicine=Comput Biol Med;;
Computers and Biomedical Research=Comput Biomed Res;;
Computers and Chemistry=Comput Chem;;
Computers In Nursing=Comput Nurs;;
Connecticut Medicine=Conn Med;;
Connective Tissue Research=Connect Tissue Res;;
Consciousness and Cognition=Conscious Cogn;;
Contact Dermatitis=Contact Dermatitis;;
Contemporary Topics In Molecular Immunology=Contemp Top Mol Immunol;;
Contraception=Contraception;;
Contraception, Fertilite, Sexualite=Contracept Fertil Sex;;
Contributions To Epidemiology and Biostatistics=Contrib Epidemiol Biostat;;
Contributions To Gynecology and Obstetrics=Contrib Gynecol Obstet;;
Contributions To Nephrology=Contrib Nephrol;;
Controlled Clinical Trials=Control Clin Trials;;
Cornea=Cornea;;
Coronary Artery Disease=Coron Artery Dis;;
Cortex=Cortex;;
Crisis=Crisis;;
Critical Care Clinics=Crit Care Clin;;
Critical Care Medicine=Crit Care Med;;
Critical Reviews In Biochemistry and Molecular Biology=Crit Rev Biochem Mol Biol;;
Critical Reviews In Biomedical Engineering=Crit Rev Biomed Eng;;
Critical Reviews In Biotechnology=Crit Rev Biotechnol;;
Critical Reviews In Clinical Laboratory Sciences=Crit Rev Clin Lab Sci;;
Critical Reviews In Diagnostic IMAging=Crit Rev Diagn Imaging;;
Critical Reviews In Eukaryotic Gene Expression=Crit Rev Eukaryot Gene Expr;;
Critical Reviews In Food Science and Nutrition=Crit Rev Food Sci Nutr;;
Critical Reviews In Immunology=Crit Rev Immunol;;
Critical Reviews In Microbiology=Crit Rev Microbiol;;
Critical Reviews In Neurobiology=Crit Rev Neurobiol;;
Critical Reviews In Oncogenesis=Crit Rev Oncog;;
Critical Reviews In Oncology/Hematology=Crit Rev Oncol Hematol;;
Critical Reviews In Oral Biology and Medicine=Crit Rev Oral Biol Med;;
Critical Reviews In Therapeutic Drug Carrier Systems=Crit Rev Ther Drug Carrier Syst;;
Critical Reviews In Toxicology=Crit Rev Toxicol;;
Cryobiology=Cryobiology;;
Cultural Diversity and Mental Health=Cult Divers Ment Health;;
Culture, Medicine and Psychiatry=Cult Med Psychiatry;;
Current Biology=Curr Biol;;
Current Clinical Topics In Infectious Diseases=Curr Clin Top Infect Dis;;
Current Eye Research=Curr Eye Res;;
Current Genetics=Curr Genet;;
Current Medical Research and Opinion=Curr Med Res Opin;;
Current Opinion In Biotechnology=Curr Opin Biotechnol;;
Current Opinion In Cardiology=Curr Opin Cardiol;;
Current Opinion In Cell Biology=Curr Opin Cell Biol;;
Current Opinion In Genetics and Development=Curr Opin Genet Dev;;
Current Opinion In Hematology=Curr Opin Hematol;;
Current Opinion In Immunology=Curr Opin Immunol;;
Current Opinion In Lipidology=Curr Opin Lipidol;;
Current Opinion In Nephrology and Hypertension=Curr Opin Nephrol Hypertens;;
Current Opinion In Neurobiology=Curr Opin Neurobiol;;
Current Opinion In Neurology=Curr Opin Neurol;;
Current Opinion In Obstetrics and Gynecology=Curr Opin Obstet Gynecol;;
Current Opinion In Oncology=Curr Opin Oncol;;
Current Opinion In Pediatrics=Curr Opin Pediatr;;
Current Opinion In Pulmonary Medicine=Curr Opin Pulm Med;;
Current Opinion In Rheumatology=Curr Opin Rheumatol;;
Current Opinion In Structural Biology=Curr Opin Struct Biol;;
Current Problems In Cancer=Curr Probl Cancer;;
Current Problems In Cardiology=Curr Probl Cardiol;;
Current Problems In Dermatology=Curr Probl Dermatol;;
Current Problems In Diagnostic Radiology=Curr Probl Diagn Radiol;;
Current Problems In Pediatrics=Curr Probl Pediatr;;
Current Problems In Surgery=Curr Probl Surg;;
Current Studies In Hematology and Blood Transfusion=Curr Stud Hematol Blood Transfus;;
Current Therapy In Endocrinology and Metabolism=Curr Ther Endocrinol Metab;;
Current Topics In Cellular Regulation=Curr Top Cell Regul;;
Current Topics In Developmental Biology=Curr Top Dev Biol;;
Current Topics In Medical Mycology=Curr Top Med Mycol;;
Current Topics In Microbiology and Immunology=Curr Top Microbiol Immunol;;
Current Topics In Neuroendocrinology=Curr Top Neuroendocrinol;;
Current Topics In Pathology=Curr Top Pathol;;
Cutis=Cutis;;
Cytobios=Cytobios;;
Cytogenetics and Cell Genetics=Cytogenet Cell Genet;;
Cytokine=Cytokine;;
Cytokine and Growth Factor Reviews=Cytokine Growth Factor Rev;;
Cytokines=Cytokines;;
Cytokines, Cellular and Molecular Therapy=Cytokines Cell Mol Ther;;
Cytometry=Cytometry;;
Cytometry. Supplement=Cytometry Suppl;;
Cytopathology=Cytopathology;;
Dakar Medical=Dakar Med;;
Danish Medical Bulletin=Dan Med Bull;;
Delaware Medical Journal=Del Med J;;
Dementia and Geriatric Cognitive Disorders=Dement Geriatr Cogn Disord;;
Demography=Demography;;
Dental Clinics of North America=Dent Clin North Am;;
Depression and Anxiety=Depress Anxiety;;
Dermatologic Clinics=Dermatol Clin;;
Dermatologic Surgery=Dermatol Surg;;
Dermatology=Dermatology;;
Dermatology Online Journal=Dermatol Online J;;
Deutsche Medizinische Wochenschrift=Dtsch Med Wochenschr;;
Development=Development;;
Development Growth and Differentiation=Dev Growth Differ;;
Development and Psychopathology=Dev Psychopathol;;
Development. Supplement=Dev Suppl;;
Developmental Biology=Dev Biol;;
Developmental and Comparative Immunology=Dev Comp Immunol;;
Developmental Dynamics=Dev Dyn;;
Developmental Genetics=Dev Genet;;
Developmental Immunology=Dev Immunol;;
Developmental Medicine and Child Neurology=Dev Med Child Neurol;;
Developmental Medicine and Child Neurology. Supplement=Dev Med Child Neurol Suppl;;
Developmental Neuroscience=Dev Neurosci;;
Developmental Psychobiology=Dev Psychobiol;;
Developmental Psychology=Dev Psychol;;
Developments In Biological Standardization=Dev Biol Stand;;
Developments In Ophthalmology=Dev Ophthalmol;;
Diabetes=Diabetes;;
Diabetes Care=Diabetes Care;;
Diabetes and Metabolism=Diabetes Metab;;
Diabetes/Metabolism Reviews=Diabetes Metab Rev;;
Diabetes Research and Clinical Practice=Diabetes Res Clin Pract;;
Diabetic Medicine=Diabet Med;;
Diabetologia=Diabetologia;;
Diagnostic Cytopathology=Diagn Cytopathol;;
Diagnostic Microbiology and Infectious Disease=Diagn Microbiol Infect Dis;;
Diagnostic Molecular Pathology=Diagn Mol Pathol;;
Differentiation=Differentiation;;
Digestion=Digestion;;
Digestive Diseases=Dig Dis;;
Digestive Diseases and Sciences=Dig Dis Sci;;
Disability and Rehabilitation=Disabil Rehabil;;
Disasters=Disasters;;
Disease Markers=Dis Markers;;
Disease-A-Month=Dis Mon;;
Diseases of The Colon and Rectum=Dis Colon Rectum;;
Diseases of The Esophagus=Dis Esophagus;;
DNA and Cell Biology=DNA Cell Biol;;
DNA Research=DNA Res;;
DNA Sequence=DNA Seq;;
Documenta Ophthalmologica=Doc Ophthalmol;;
Doklady Akademii Nauk=Dokl Akad Nauk;;
Domestic Animal Endocrinology=Domest Anim Endocrinol;;
Downs Syndrome Research and Practice=Downs Syndr Res Pract;;
Drug and Alcohol Dependence=Drug Alcohol Depend;;
Drug and Chemical Toxicology=Drug Chem Toxicol;;
Drug Design and Discovery (Yverdon-Les-Bains=Drug Des Discov;;
Drug Metabolism and Disposition=Drug Metab Dispos;;
Drug Metabolism and Drug Interactions=Drug Metabol Drug Interact;;
Drug Metabolism Reviews=Drug Metab Rev;;
Drug Safety=Drug Saf;;
Drug and Therapeutics Bulletin=Drug Ther Bull;;
Drugs=Drugs;;
Drugs and Aging=Drugs Aging;;
Drugs Under Experimental and Clinical Research=Drugs Exp Clin Res;;
DTW. Deutsche Tierarztliche Wochenschrift=DTW Dtsch Tierarztl Wochenschr;;
Duodecim=Duodecim;;
Dysphagia=Dysphagia;;
Ear and Hearing=Ear Hear;;
Ear, Nose, and Throat Journal=Ear Nose Throat J;;
Early Human Development=Early Hum Dev;;
Early Pregnancy=Early Pregnancy;;
East African Medical Journal=East Afr Med J;;
Ecotoxicology and Environmental Safety=Ecotoxicol Environ Saf;;
Eisei Shikenjo Hokoku. Bulletin of National Institute Of Hygienic Sciences=Eisei Shikenjo Hokoku;;
Eksperimentalnaia I Klinicheskaia Farmakologiia=Eksp Klin Farmakol;;
Electroencephalography and Clinical Neurophysiology=Electroencephalogr Clin Neurophysiol;;
Electroencephalography and Clinical Neurophysiology. Supplement=Electroencephalogr Clin Neurophysiol Suppl;;
Electromyography and Clinical Neurophysiology=Electromyogr Clin Neurophysiol;;
Electrophoresis=Electrophoresis;;
EMBO Journal=EMBO J;;
Emergency Medicine Clinics of North America=Emerg Med Clin North Am;;
Emerging Infectious Diseases=Emerg Infect Dis;;
Encephale=Encephale;;
Endeavour=Endeavour;;
Endocrine=Endocrine;;
Endocrine Journal=Endocr J;;
Endocrine Research=Endocr Res;;
Endocrine Reviews=Endocr Rev;;
Endocrinology=Endocrinology;;
Endocrinology and Metabolism Clinics of North America=Endocrinol Metab Clin North Am;;
Endoscopy=Endoscopy;;
Endothelium=Endothelium;;
Enfermedades Infecciosas Y Microbiologia Clinica=Enferm Infecc Microbiol Clin;;
Environmental Health Perspectives=Environ Health Perspect;;
Environmental and Molecular Mutagenesis=Environ Mol Mutagen;;
Environmental Research=Environ Res;;
Epidemiologia E Prevenzione=Epidemiol Prev;;
Epidemiologia E Psichiatria Sociale=Epidemiol Psichiatr Soc;;
Epidemiologic Reviews=Epidemiol Rev;;
Epidemiological Bulletin=Epidemiol Bull;;
Epidemiologie, Mikrobiologie, Imunologie=Epidemiol Mikrobiol Imunol;;
Epidemiology=Epidemiology;;
Epidemiology and Infection=Epidemiol Infect;;
Epilepsia=Epilepsia;;
Epilepsy Research=Epilepsy Res;;
Epilepsy Research. Supplement=Epilepsy Res Suppl;;
Equine Veterinary Journal=Equine Vet J;;
Ergonomics=Ergonomics;;
Essays In Biochemistry=Essays Biochem;;
Ethiopian Medical Journal=Ethiop Med J;;
Ethnicity and Disease=Ethn Dis;;
Ethnicity and Health=Ethn Health;;
European Archives of Oto-Rhino-Laryngology=Eur Arch Otorhinolaryngol;;
European Archives of Oto-Rhino-Laryngology. Supplement=Eur Arch Otorhinolaryngol Suppl;;
European Archives of Psychiatry and Clinical Neuroscience=Eur Arch Psychiatry Clin Neurosci;;
European Biophysics Journal=Eur Biophys J;;
European Child and Adolescent Psychiatry=Eur Child Adolesc Psychiatry;;
European Cytokine Network=Eur Cytokine Netw;;
European Heart Journal=Eur Heart J;;
European Journal of Anaesthesiology=Eur J Anaesthesiol;;
European Journal of Anaesthesiology. Supplement=Eur J Anaesthesiol Suppl;;
European Journal of Applied Physiology and Occupational Physiology=Eur J Appl Physiol;;
European Journal of Biochemistry=Eur J Biochem;;
European Journal of Cancer=Eur J Cancer;;
European Journal of Cancer Prevention=Eur J Cancer Prev;;
European Journal of Cardio-Thoracic Surgery=Eur J Cardiothorac Surg;;
European Journal of Cell Biology=Eur J Cell Biol;;
European Journal of Cell Biology. Supplement=Eur J Cell Biol Suppl;;
European Journal of Clinical Investigation=Eur J Clin Invest;;
European Journal of Clinical Microbiology and Infectious Diseases=Eur J Clin Microbiol Infect Dis;;
European Journal of Clinical Nutrition=Eur J Clin Nutr;;
European Journal of Clinical Pharmacology=Eur J Clin Pharmacol;;
European Journal of Drug Metabolism and Pharmacokinetics=Eur J Drug Metab Pharmacokinet;;
European Journal of Emergency Medicine=Eur J Emerg Med;;
European Journal of Endocrinology=Eur J Endocrinol;;
European Journal of Epidemiology=Eur J Epidemiol;;
European Journal of Gastroenterology and Hepatology=Eur J Gastroenterol Hepatol;;
European Journal of Gynaecological Oncology=Eur J Gynaecol Oncol;;
European Journal of Haematology=Eur J Haematol;;
European Journal of Haematology. Supplementum=Eur J Haematol Suppl;;
European Journal of Histochemistry=Eur J Histochem;;
European Journal of Human Genetics=Eur J Hum Genet;;
European Journal of Immunogenetics=Eur J Immunogenet;;
European Journal of Immunology=Eur J Immunol;;
European Journal of Medical Research=Eur J Med Res;;
European Journal of Morphology=Eur J Morphol;;
European Journal of Neuroscience=Eur J Neurosci;;
European Journal of Nuclear Medicine=Eur J Nucl Med;;
European Journal of Obstetrics, Gynecology, and Reproductive Biology=Eur J Obstet Gynecol Reprod Biol;;
European Journal of Ophthalmology=Eur J Ophthalmol;;
European Journal of Oral Sciences=Eur J Oral Sci;;
European Journal of Orthodontics=Eur J Orthod;;
European Journal of Pediatric Surgery=Eur J Pediatr Surg;;
European Journal of Pediatrics=Eur J Pediatr;;
European Journal of Pharmacology=Eur J Pharmacol;;
European Journal of Radiology=Eur J Radiol;;
European Journal of Rheumatology and Inflammation=Eur J Rheumatol Inflamm;;
European Journal of Surgery=Eur J Surg;;
European Journal of Surgical Oncology=Eur J Surg Oncol;;
European Journal of Vascular and Endovascular Surgery=Eur J Vasc Endovasc Surg;;
European Neurology=Eur Neurol;;
European Neuropsychopharmacology=Eur Neuropsychopharmacol;;
European Radiology=Eur Radiol;;
European Respiratory Journal=Eur Respir J;;
European Respiratory Journal. Supplement=Eur Respir J Suppl;;
European Review For Medical and Pharmacological Sciences=Eur Rev Med Pharmacol Sci;;
European Spine Journal=Eur Spine J;;
European Surgical Research=Eur Surg Res;;
European Urology=Eur Urol;;
Evolutionary Computation=Evol Comput;;
Exercise Immunology Review=Exerc Immunol Rev;;
Exercise and Sport Sciences Reviews=Exerc Sport Sci Rev;;
Experimental Aging Research=Exp Aging Res;;
Experimental Animals=Exp Anim;;
Experimental and Applied Acarology=Exp Appl Acarol;;
Experimental Brain Research=Exp Brain Res;;
Experimental Cell Research=Exp Cell Res;;
Experimental and Clinical Endocrinology And Diabetes=Exp Clin Endocrinol Diabetes;;
Experimental and Clinical Immunogenetics=Exp Clin Immunogenet;;
Experimental and Clinical Psychopharmacology=Exp Clin Psychopharmacol;;
Experimental Dermatology=Exp Dermatol;;
Experimental Eye Research=Exp Eye Res;;
Experimental Gerontology=Exp Gerontol;;
Experimental Hematology=Exp Hematol;;
Experimental Lung Research=Exp Lung Res;;
Experimental and Molecular Pathology=Exp Mol Pathol;;
Experimental Nephrology=Exp Nephrol;;
Experimental Neurology=Exp Neurol;;
Experimental Parasitology=Exp Parasitol;;
Experimental Physiology=Exp Physiol;;
Experimental and Toxicologic Pathology=Exp Toxicol Pathol;;
Eye=Eye;;
Fa I Hsueh Tsa Chih Journal of Forensic Medicine (Shang-Hai=Fa I Hsueh Tsa Chih;;
Family Medicine=Fam Med;;
Family Planning Perspectives=Fam Plann Perspect;;
Family Practice=Fam Pract;;
Family Process=Fam Process;;
FAO Food and Nutrition Paper=FAO Food Nutr Pap;;
Faraday Discussions=Faraday Discuss;;
Farmaco=Farmaco;;
FASEB Journal=FASEB J;;
FEBS Letters=FEBS Lett;;
FEMS Immunology and Medical Microbiology=FEMS Immunol Med Microbiol;;
FEMS Microbiology Letters=FEMS Microbiol Lett;;
FEMS Microbiology Reviews=FEMS Microbiol Rev;;
Fertility and Sterility=Fertil Steril;;
Fetal Diagnosis and Therapy=Fetal Diagn Ther;;
Fiziologiia Cheloveka=Fiziol Cheloveka;;
Fogorvosi Szemle=Fogorv Sz;;
Folding and Design=Fold Des;;
Folia Biologica=Folia Biol (Praha);;
Folia Biologica=Folia Biol (Krakow);;
Folia Histochemica Et Cytobiologica=Folia Histochem Cytobiol;;
Folia Medica=Folia Med (Plovdiv);;
Folia Medica Cracoviensia=Folia Med Cracov;;
Folia Microbiologica=Folia Microbiol (Praha);;
Folia Morphologica=Folia Morphol (Warsz);;
Folia Parasitologica=Folia Parasitol (Praha);;
Folia Phoniatrica Et Logopedica=Folia Phoniatr Logop;;
Folia Primatologica=Folia Primatol (Basel);;
Food Additives and Contaminants=Food Addit Contam;;
Food and Chemical Toxicology=Food Chem Toxicol;;
Foot and Ankle International=Foot Ankle Int;;
Forensic Science International=Forensic Sci Int;;
Fortschritte Der Chemie Organischer Naturstoffe=Fortschr Chem Org Naturst;;
Fortschritte Der Medizin=Fortschr Med;;
Fortschritte Der Medizin. Supplement=Fortschr Med Suppl;;
Fortschritte Der Neurologie-Psychiatrie=Fortschr Neurol Psychiatr;;
Free Radical Biology and Medicine=Free Radic Biol Med;;
Free Radical Research=Free Radic Res;;
Frontiers In Bioscience=Front Biosci;;
Frontiers of Medical and Biological Engineering=Front Med Biol Eng;;
Frontiers In Neuroendocrinology=Front Neuroendocrinol;;
Frontiers of Radiation Therapy and Oncology=Front Radiat Ther Oncol;;
Fukuoka Igaku Zasshi. Fukuoka Acta Medica=Fukuoka Igaku Zasshi;;
Fukushima Journal of Medical Science=Fukushima J Med Sci;;
Functional Neurology=Funct Neurol;;
Fundamental and Clinical Pharmacology=Fundam Clin Pharmacol;;
Fungal Genetics and Biology=Fungal Genet Biol;;
Future of Children=Future Child;;
Gaceta Medica de Mexico=Gac Med Mex;;
Gaceta Sanitaria=Gac Sanit;;
Gan To Kagaku Ryoho [Japanese Journal of Cancer and Chemotherapy]=Gan To Kagaku Ryoho;;
Gastroenterologia Y Hepatologia=Gastroenterol Hepatol;;
Gastroenterologie Clinique Et Biologique=Gastroenterol Clin Biol;;
Gastroenterologist=Gastroenterologist;;
Gastroenterology=Gastroenterology;;
Gastroenterology Clinics of North America=Gastroenterol Clin North Am;;
Gastrointestinal Endoscopy=Gastrointest Endosc;;
Gastrointestinal Endoscopy Clinics of North America=Gastrointest Endosc Clin N Am;;
Gene=Gene;;
Gene Expression=Gene Expr;;
Gene Geography=Gene Geogr;;
Gene Therapy=Gene Ther;;
General and Comparative Endocrinology=Gen Comp Endocrinol;;
General and Diagnostic Pathology=Gen Diagn Pathol;;
General Hospital Psychiatry=Gen Hosp Psychiatry;;
General Pharmacology=Gen Pharmacol;;
General Physiology and Biophysics=Gen Physiol Biophys;;
Genes, Chromosomes and Cancer=Genes Chromosomes Cancer;;
Genes and Development=Genes Dev;;
Genes and Genetic Systems=Genes Genet Syst;;
Genes To Cells=Genes Cells;;
Genetic Analysis=Genet Anal;;
Genetic Counseling=Genet Couns;;
Genetic Epidemiology=Genet Epidemiol;;
Genetic Epidemiology. Supplement=Genet Epidemiol Suppl;;
Genetic, Social, and General Psychology Monographs=Genet Soc Gen Psychol Monogr;;
Genetica=Genetica;;
Genetical Research=Genet Res;;
Genetics=Genetics;;
Genetika=Genetika;;
Genome=Genome;;
Genome Research=Genome Res;;
Genomics=Genomics;;
Geriatric Nephrology and Urology=Geriatr Nephrol Urol;;
Geriatrics=Geriatrics;;
Gerontologist=Gerontologist;;
Gerontology=Gerontology;;
Gesnerus=Gesnerus;;
Gesnerus. Supplement=Gesnerus Suppl;;
Gesundheitswesen=Gesundheitswesen;;
Gigiena I Sanitariia=Gig Sanit;;
Ginecologia Y Obstetricia de Mexico=Ginecol Obstet Mex;;
Ginekologia Polska=Ginekol Pol;;
Giornale di Chirurgia=G Chir;;
Giornale Italiano di Cardiologia=G Ital Cardiol;;
Glas. Srpska Akademija Nauka I Umetnosti, Odeljenje Medicinskih Nauka=Glas Srp Akad Nauka [Med];;
Glia=Glia;;
Glycobiology=Glycobiology;;
Glycoconjugate Journal=Glycoconj J;;
Graefes Archive For Clinical and Experimental Ophthalmology=Graefes Arch Clin Exp Ophthalmol;;
Growth, Development, and Aging=Growth Dev Aging;;
Growth Factors (Yverdon-Les-Bains=Growth Factors;;
Growth Regulation=Growth Regul;;
Gut=Gut;;
Gynakologisch-Geburtshilfliche Rundschau=Gynakol Geburtshilfliche Rundsch;;
Gynecologic and Obstetric Investigation=Gynecol Obstet Invest;;
Gynecologic Oncology=Gynecol Oncol;;
Gynecological Endocrinology=Gynecol Endocrinol;;
Haematologia=Haematologia (Budap);;
Haematologica=Haematologica;;
Haemostasis=Haemostasis;;
Hand Clinics=Hand Clin;;
Handchirurgie, Mikrochirurgie, Plastische Chirurgie=Handchir Mikrochir Plast Chir;;
Harefuah=Harefuah;;
Harvard Review of Psychiatry=Harv Rev Psychiatry;;
Harvey Lectures=Harvey Lect;;
Hastings Center Report=Hastings Cent Rep;;
Hautarzt=Hautarzt;;
Hawaii Medical Journal=Hawaii Med J;;
Head and Neck=Head Neck;;
Headache=Headache;;
Health Affairs=Health Aff (Millwood);;
Health Bulletin=Health Bull (Edinb);;
Health Care Management Review=Health Care Manage Rev;;
Health Devices=Health Devices;;
Health Economics=Health Econ;;
Health Education and Behavior=Health Educ Behav;;
Health Education and Behavior. Supplement=Health Educ Behav Suppl;;
Health Physics=Health Phys;;
Health Psychology=Health Psychol;;
Health Reports=Health Rep;;
Health Services Research=Health Serv Res;;
Health and Social Work=Health Soc Work;;
Health Technology Assessment=Health Technol Assess (Winch Eng);;
Hearing Research=Hear Res;;
Heart=Heart;;
Heart and Lung=Heart Lung;;
Heart and Vessels=Heart Vessels;;
Heart and Vessels. Supplement=Heart Vessels Suppl;;
Helicobacter=Helicobacter;;
Hematological Oncology=Hematol Oncol;;
Hematology and Cell Therapy=Hematol Cell Ther;;
Hematology/Oncology Clinics of North America=Hematol Oncol Clin North Am;;
Hematopathology and Molecular Hematology=Hematopathol Mol Hematol;;
Hemoglobin=Hemoglobin;;
Hepato-Gastroenterology=Hepatogastroenterology;;
Hepatology=Hepatology;;
Hereditas=Hereditas;;
Heredity=Heredity;;
Herz=Herz;;
Hindustan Antibiotics Bulletin=Hindustan Antibiot Bull;;
Hinyokika Kiyo. Acta Urologica Japonica=Hinyokika Kiyo;;
Hippocampus=Hippocampus;;
Hiroshima Journal of Medical Sciences=Hiroshima J Med Sci;;
Histochemical Journal=Histochem J;;
Histochemistry and Cell Biology=Histochem Cell Biol;;
Histology and Histopathology=Histol Histopathol;;
Histopathology=Histopathology;;
HNO=HNO;;
Hokkaido Igaku Zasshi. Hokkaido Journal of Medical Science=Hokkaido Igaku Zasshi;;
Hormone and Metabolic Research=Horm Metab Res;;
Hormone and Metabolic Research. Supplement=Horm Metab Res Suppl;;
Hormone Research=Horm Res;;
Hormones and Behavior=Horm Behav;;
Hospital Practice (Office Edition)=Hosp Pract (Off Ed);;
Hospitals and Health Networks=Hosp Health Netw;;
HPB Surgery (Yverdon-Les-Bains=HPB Surg;;
Hua Hsi Kou Chiang I Hsueh Tsa Chih West China Journal Of Stomatology (Cheng-Tu=Hua Hsi Kou Chiang I Hsueh Tsa Chih;;
Hua-Hsi I Ko Ta Hsueh Hsueh Pao [Journal of West China University Of Medical Sciences]=Hua Hsi I Ko Ta Hsueh Hsueh Pao;;
Human Antibodies=Hum Antibodies;;
Human Biology=Hum Biol;;
Human Cell=Hum Cell;;
Human and Experimental Toxicology=Hum Exp Toxicol;;
Human Factors=Hum Factors;;
Human Gene Therapy=Hum Gene Ther;;
Human Genetics=Hum Genet;;
Human Heredity=Hum Hered;;
Human Immunology=Hum Immunol;;
Human Molecular Genetics=Hum Mol Genet;;
Human Mutation=Hum Mutat;;
Human Pathology=Hum Pathol;;
Human Reproduction=Hum Reprod;;
Human Reproduction Update=Hum Reprod Update;;
Hu-Nan I Ko Ta Hsueh Hsueh Pao Bulletin of Hunan Medical University (Chang-Sha=Hunan I Ko Ta Hsueh Hsueh Pao;;
Hybridoma=Hybridoma;;
Hypertension=Hypertension;;
Hypertension Research=Hypertens Res;;
I Chuan Hsueh Pao. Acta Genetica Sinica=I Chuan Hsueh Pao;;
IARC Monographs on The Evaluation of Carcinogenic Risks To Humans=IARC Monogr Eval Carcinog Risks Hum;;
IARC Monographs on The Evaluation of Carcinogenic Risks To Humans. Supplement=IARC Monogr Eval Carcinog Risks Hum Suppl;;
IARC Scientific Publications=IARC Sci Publ;;
IEEE Engineering In Medicine and Biology Magazine=IEEE Eng Med Biol Mag;;
IEEE Transactions on Biomedical Engineering=IEEE Trans Biomed Eng;;
IEEE Transactions on Medical IMAging=IEEE Trans Med Imaging;;
IEEE Transactions on Rehabilitation Engineering=IEEE Trans Rehabil Eng;;
IMA Journal of Mathematics Applied In Medicine and Biology=IMA J Math Appl Med Biol;;
IMAge - The Journal of Nursing Scholarship=Image J Nurs Sch;;
Immunity=Immunity;;
Immunobiology=Immunobiology;;
Immunogenetics=Immunogenetics;;
Immunologic Research=Immunol Res;;
Immunological Investigations=Immunol Invest;;
Immunological Reviews=Immunol Rev;;
Immunology=Immunology;;
Immunology and Cell Biology=Immunol Cell Biol;;
Immunology Letters=Immunol Lett;;
Immunology Series=Immunol Ser;;
Immunology. Supplement=Immunol Suppl;;
Immunology Today=Immunol Today;;
Immunopharmacology=Immunopharmacology;;
Immunopharmacology and Immunotoxicology=Immunopharmacol Immunotoxicol;;
Immunotechnology=Immunotechnology;;
Important Advances In Oncology=Important Adv Oncol;;
In Vitro Cellular and Developmental Biology. Animal=In Vitro Cell Dev Biol Anim;;
In Vivo=In Vivo;;
Indian Heart Journal=Indian Heart J;;
Indian Journal of Biochemistry and Biophysics=Indian J Biochem Biophys;;
Indian Journal of Cancer=Indian J Cancer;;
Indian Journal of Chest Diseases and Allied Sciences=Indian J Chest Dis Allied Sci;;
Indian Journal of Experimental Biology=Indian J Exp Biol;;
Indian Journal of Gastroenterology=Indian J Gastroenterol;;
Indian Journal of Leprosy=Indian J Lepr;;
Indian Journal of Malariology=Indian J Malariol;;
Indian Journal of Medical Research=Indian J Med Res;;
Indian Journal of Medical Sciences=Indian J Med Sci;;
Indian Journal of Ophthalmology=Indian J Ophthalmol;;
Indian Journal of Pathology and Microbiology=Indian J Pathol Microbiol;;
Indian Journal of Pediatrics=Indian J Pediatr;;
Indian Journal of Physiology and Pharmacology=Indian J Physiol Pharmacol;;
Indian Journal of Public Health=Indian J Public Health;;
Indian Pediatrics=Indian Pediatr;;
Industrial Health=Ind Health;;
Infection=Infection;;
Infection Control and Hospital Epidemiology=Infect Control Hosp Epidemiol;;
Infection and Immunity=Infect Immun;;
Infectious Disease Clinics of North America=Infect Dis Clin North Am;;
Inflammation=Inflammation;;
Inflammation Research=Inflamm Res;;
Injury=Injury;;
Injury Prevention=Inj Prev;;
Inquiry=Inquiry;;
Insect Biochemistry and Molecular Biology=Insect Biochem Mol Biol;;
Insect Molecular Biology=Insect Mol Biol;;
Instructional Course Lectures=Instr Course Lect;;
Integrative Physiological and Behavioral Science=Integr Physiol Behav Sci;;
Intensive Care Medicine=Intensive Care Med;;
Internal Medicine=Intern Med;;
International Anesthesiology Clinics=Int Anesthesiol Clin;;
International Angiology=Int Angiol;;
International Archives of Allergy and Immunology=Int Arch Allergy Immunol;;
International Archives of Occupational and Environmental Health=Int Arch Occup Environ Health;;
International Clinical Psychopharmacology=Int Clin Psychopharmacol;;
International Dental Journal=Int Dent J;;
International Immunology=Int Immunol;;
International Journal of Aging and Human Development=Int J Aging Hum Dev;;
International Journal of Andrology=Int J Androl;;
International Journal of Artificial Organs=Int J Artif Organs;;
International Journal of Biochemistry and Cell Biology=Int J Biochem Cell Biol;;
International Journal of Biological Macromolecules=Int J Biol Macromol;;
International Journal of Biological Markers=Int J Biol Markers;;
International Journal of Biometeorology=Int J Biometeorol;;
International Journal of Cancer=Int J Cancer;;
International Journal of Cancer. Supplement=Int J Cancer Suppl;;
International Journal of Cardiac IMAging=Int J Card Imaging;;
International Journal of Cardiology=Int J Cardiol;;
International Journal of Circumpolar Health=Int J Circumpolar Health;;
International Journal of Circumpolar Health. Supplement=Int J Circumpolar Health Suppl;;
International Journal of Clinical and Experimental Hypnosis=Int J Clin Exp Hypn;;
International Journal of Clinical and Laboratory Research=Int J Clin Lab Res;;
International Journal of Clinical Pharmacology Research=Int J Clin Pharmacol Res;;
International Journal of Clinical Pharmacology and Therapeutics=Int J Clin Pharmacol Ther;;
International Journal of Clinical Practice=Int J Clin Pract;;
International Journal of Clinical Practice. Supplement=Int J Clin Pract Suppl;;
International Journal of Colorectal Disease=Int J Colorectal Dis;;
International Journal of Dermatology=Int J Dermatol;;
International Journal of Developmental Biology=Int J Dev Biol;;
International Journal of Developmental Neuroscience=Int J Dev Neurosci;;
International Journal of Eating Disorders=Int J Eat Disord;;
International Journal of Epidemiology=Int J Epidemiol;;
International Journal of Experimental Pathology=Int J Exp Pathol;;
International Journal of Food Microbiology=Int J Food Microbiol;;
International Journal of Food Sciences and Nutrition=Int J Food Sci Nutr;;
International Journal of Geriatric Psychiatry=Int J Geriatr Psychiatry;;
International Journal of Group Psychotherapy=Int J Group Psychother;;
International Journal of Gynaecology and Obstetrics=Int J Gynaecol Obstet;;
International Journal of Gynecological Pathology=Int J Gynecol Pathol;;
International Journal of Health Services=Int J Health Serv;;
International Journal of Hematology=Int J Hematol;;
International Journal of Hyperthermia=Int J Hyperthermia;;
International Journal of Immunopharmacology=Int J Immunopharmacol;;
International Journal of Impotence Research=Int J Impot Res;;
International Journal of Law and Psychiatry=Int J Law Psychiatry;;
International Journal of Legal Medicine=Int J Legal Med;;
International Journal of Leprosy and Other Mycobacterial Diseases=Int J Lepr Other Mycobact Dis;;
International Journal of Medical Informatics=Int J Med Inf;;
International Journal of Neural Systems=Int J Neural Syst;;
International Journal of Neuroscience=Int J Neurosci;;
International Journal of Nursing Studies=Int J Nurs Stud;;
International Journal of Obesity and Related Metabolic Disorders=Int J Obes Relat Metab Disord;;
International Journal of Occupational Medicine and Environmental Health=Int J Occup Med Environ Health;;
International Journal of Oncology=Int J Oncol;;
International Journal of Oral and Maxillofacial Implants=Int J Oral Maxillofac Implants;;
International Journal of Oral and Maxillofacial Surgery=Int J Oral Maxillofac Surg;;
International Journal of Pancreatology=Int J Pancreatol;;
International Journal For Parasitology=Int J Parasitol;;
International Journal of Pediatric Otorhinolaryngology=Int J Pediatr Otorhinolaryngol;;
International Journal of Psychiatry In Medicine=Int J Psychiatry Med;;
International Journal of Psycho-Analysis=Int J Psychoanal;;
International Journal of Psychophysiology=Int J Psychophysiol;;
International Journal For Quality In Health Care=Int J Qual Health Care;;
International Journal of Radiation Biology=Int J Radiat Biol;;
International Journal of Radiation Oncology, Biology, Physics=Int J Radiat Oncol Biol Phys;;
International Journal of Rehabilitation Research=Int J Rehabil Res;;
International Journal of Social Psychiatry=Int J Soc Psychiatry;;
International Journal of Sport Nutrition=Int J Sport Nutr;;
International Journal of Sports Medicine=Int J Sports Med;;
International Journal of STD and AIDS=Int J STD AIDS;;
International Journal of Systematic Bacteriology=Int J Syst Bacteriol;;
International Journal of Technology Assessment In Health Care=Int J Technol Assess Health Care;;
International Journal of Tissue Reactions=Int J Tissue React;;
International Journal of Tuberculosis and Lung Disease=Int J Tuberc Lung Dis;;
International Journal of Urology=Int J Urol;;
International Journal For Vitamin and Nutrition Research=Int J Vitam Nutr Res;;
International Journal For Vitamin and Nutrition Research. Supplement=Int J Vitam Nutr Res Suppl;;
International Nursing Review=Int Nurs Rev;;
International Ophthalmology=Int Ophthalmol;;
International Ophthalmology Clinics=Int Ophthalmol Clin;;
International Orthopaedics=Int Orthop;;
International Psychogeriatrics=Int Psychogeriatr;;
International Review of Cytology=Int Rev Cytol;;
International Review of Experimental Pathology=Int Rev Exp Pathol;;
International Review of Neurobiology=Int Rev Neurobiol;;
International Reviews of Immunology=Int Rev Immunol;;
International Surgery=Int Surg;;
International Urogynecology Journal and Pelvic Floor Dysfunction=Int Urogynecol J Pelvic Floor Dysfunct;;
International Urology and Nephrology=Int Urol Nephrol;;
Internist=Internist (Berl);;
Intervirology=Intervirology;;
Invasion and Metastasis=Invasion Metastasis;;
Invertebrate Neuroscience=Invert Neurosci;;
Investigacion Clinica=Invest Clin;;
Investigational New Drugs=Invest New Drugs;;
Investigative Ophthalmology and Visual Science=Invest Ophthalmol Vis Sci;;
Investigative Radiology=Invest Radiol;;
Ion Channels=Ion Channels;;
Iowa Medicine=Iowa Med;;
Irish Journal of Medical Science=Ir J Med Sci;;
Irish Medical Journal=Ir Med J;;
ISA Transactions=ISA Trans;;
Isis=Isis;;
Israel Journal of Medical Sciences=Isr J Med Sci;;
Israel Journal of Psychiatry and Related Sciences=Isr J Psychiatry Relat Sci;;
Issues In Law and Medicine=Issues Law Med;;
Italian Journal of Anatomy and Embryology=Ital J Anat Embryol;;
Italian Journal of Biochemistry=Ital J Biochem;;
Italian Journal of Neurological Sciences=Ital J Neurol Sci;;
Izvestiia Akademii Nauk. Seriia Biologicheskaia=Izv Akad Nauk Ser Biol;;
Jahresbericht / Schweizerische Akademie Der Medizinischen Wissenschaften=Jahresber Schweiz Akad Med Wiss;;
JAMA=JAMA;;
Japanese Circulation Journal=Jpn Circ J;;
Japanese Heart Journal=Jpn Heart J;;
Japanese Journal of Antibiotics=Jpn J Antibiot;;
Japanese Journal of Cancer Research=Jpn J Cancer Res;;
Japanese Journal of Clinical Oncology=Jpn J Clin Oncol;;
Japanese Journal of Medical Science and Biology=Jpn J Med Sci Biol;;
Japanese Journal of Ophthalmology=Jpn J Ophthalmol;;
Japanese Journal of Pharmacology=Jpn J Pharmacol;;
Japanese Journal of Physiology=Jpn J Physiol;;
Japanese Journal of Veterinary Research=Jpn J Vet Res;;
Journal of Biochemical and Molecular Toxicology=J Biochem Mol Toxicol;;
Journal of Clinical Monitoring and Computing=J Clin Monit Comput;;
Journal of Clinical Virology=J Clin Virol;;
Joint Commission Journal on Quality Improvement=Jt Comm J Qual Improv;;
Journal of Abnormal Child Psychology=J Abnorm Child Psychol;;
Journal of Abnormal Psychology=J Abnorm Psychol;;
Journal of Accident and Emergency Medicine=J Accid Emerg Med;;
Journal of The Acoustical Society Of America=J Acoust Soc Am;;
Journal of Acquired Immune Deficiency Syndromes and Human Retrovirology=J Acquir Immune Defic Syndr Hum Retrovirol;;
Journal of Addictive Diseases=J Addict Dis;;
Journal of Adolescence=J Adolesc;;
Journal of Adolescent Health=J Adolesc Health;;
Journal of Advanced Nursing=J Adv Nurs;;
Journal of Affective Disorders=J Affect Disord;;
Journal of The Air and Waste Management Association=J Air Waste Manag Assoc;;
Journal of Allergy and Clinical Immunology=J Allergy Clin Immunol;;
Journal of Allied Health=J Allied Health;;
Journal of Alternative and Complementary Medicine=J Altern Complement Med;;
Journal of The American Academy Of Audiology (Hamilton, Ont.=J Am Acad Audiol;;
Journal of The American Academy Of Child and Adolescent Psychiatry=J Am Acad Child Adolesc Psychiatry;;
Journal of The American Academy Of Dermatology=J Am Acad Dermatol;;
Journal of The American Academy Of Psychiatry and The Law=J Am Acad Psychiatry Law;;
Journal of The American Academy Of Psychoanalysis=J Am Acad Psychoanal;;
Journal of The American Animal Hospital Association=J Am Anim Hosp Assoc;;
Journal of The American Association Of Gynecologic Laparoscopists=J Am Assoc Gynecol Laparosc;;
Journal of The American Board Of Family Practice=J Am Board Fam Pract;;
Journal of The American College Of Cardiology=J Am Coll Cardiol;;
Journal of The American College Of Dentists=J Am Coll Dent;;
Journal of American College Health=J Am Coll Health;;
Journal of The American College Of Nutrition=J Am Coll Nutr;;
Journal of The American College Of Surgeons=J Am Coll Surg;;
Journal of The American Dental Association=J Am Dent Assoc;;
Journal of The American Dietetic Association=J Am Diet Assoc;;
Journal of The American Geriatrics Society=J Am Geriatr Soc;;
Journal of The American Medical Informatics Association=J Am Med Inform Assoc;;
Journal of The American Medical Womens Association=J Am Med Womens Assoc;;
Journal of The American Mosquito Control Association=J Am Mosq Control Assoc;;
Journal of The American Mosquito Control Association. Supplement=J Am Mosq Control Assoc Suppl;;
Journal of The American Optometric Association=J Am Optom Assoc;;
Journal of The American Osteopathic Association=J Am Osteopath Assoc;;
Journal of The American Pharmaceutical Association=J Am Pharm Assoc (Wash);;
Journal of The American Podiatric Medical Association=J Am Podiatr Med Assoc;;
Journal of The American Psychoanalytic Association=J Am Psychoanal Assoc;;
Journal of The American Society Of Echocardiography=J Am Soc Echocardiogr;;
Journal of The American Society Of Nephrology=J Am Soc Nephrol;;
Journal of The American Veterinary Medical Association=J Am Vet Med Assoc;;
Journal of Analytical Psychology=J Anal Psychol;;
Journal of Analytical Toxicology=J Anal Toxicol;;
Journal of Anatomy=J Anat;;
Journal of Andrology=J Androl;;
Journal of Animal Science=J Anim Sci;;
Journal of Antibiotics=J Antibiot (Tokyo);;
Journal of Antimicrobial Chemotherapy=J Antimicrob Chemother;;
Journal of Anxiety Disorders=J Anxiety Disord;;
Journal of AOAC International=J AOAC Int;;
Journal of Applied Behavior Analysis=J Appl Behav Anal;;
Journal of Applied Microbiology=J Appl Microbiol;;
Journal of Applied Physiology=J Appl Physiol;;
Journal of Applied Psychology=J Appl Psychol;;
Journal of Applied Toxicology=J Appl Toxicol;;
Journal of The Arkansas Medical Society=J Ark Med Soc;;
Journal of Arthroplasty=J Arthroplasty;;
Journal of Assisted Reproduction and Genetics=J Assist Reprod Genet;;
Journal of The Association For Academic Minority Physicians=J Assoc Acad Minor Phys;;
Journal of The Association Of Nurses In AIDS Care=J Assoc Nurses AIDS Care;;
Journal of The Association Of Physicians Of India=J Assoc Physicians India;;
Journal of Asthma=J Asthma;;
Journal of Atherosclerosis and Thrombosis=J Atheroscler Thromb;;
Journal of Audiovisual Media In Medicine=J Audiov Media Med;;
Journal of Autism and Developmental Disorders=J Autism Dev Disord;;
Journal of Autoimmunity=J Autoimmun;;
Journal of The Autonomic Nervous System=J Auton Nerv Syst;;
Journal of Autonomic Pharmacology=J Auton Pharmacol;;
Journal of Bacteriology=J Bacteriol;;
Journal of Basic and Clinical Physiology And Pharmacology=J Basic Clin Physiol Pharmacol;;
Journal of Basic Microbiology=J Basic Microbiol;;
Journal of Behavior Therapy and Experimental Psychiatry=J Behav Ther Exp Psychiatry;;
Journal of Behavioral Health Services and Research=J Behav Health Serv Res;;
Journal of Behavioral Medicine=J Behav Med;;
Journal Belge de Radiologie=J Belge Radiol;;
Journal of Biochemical and Biophysical Methods=J Biochem Biophys Methods;;
Journal of Biochemistry=J Biochem (Tokyo);;
Journal of Biocommunication=J Biocommun;;
Journal of Bioenergetics and Biomembranes=J Bioenerg Biomembr;;
Journal of Biological Chemistry=J Biol Chem;;
Journal of Biological Photography=J Biol Photogr;;
Journal of Biological Regulators and Homeostatic Agents=J Biol Regul Homeost Agents;;
Journal of Biological Rhythms=J Biol Rhythms;;
Journal of Bioluminescence and Chemiluminescence=J Biolumin Chemilumin;;
Journal of Biomaterials Applications=J Biomater Appl;;
Journal of Biomaterials Science, Polymer Edition=J Biomater Sci Polym Ed;;
Journal of Biomechanical Engineering=J Biomech Eng;;
Journal of Biomechanics=J Biomech;;
Journal of Biomedical Materials Research=J Biomed Mater Res;;
Journal of Biomolecular NMR=J Biomol NMR;;
Journal of Biomolecular Structure and Dynamics=J Biomol Struct Dyn;;
Journal of Biopharmaceutical Statistics=J Biopharm Stat;;
Journal of Biosocial Science=J Biosoc Sci;;
Journal of Bone and Joint Surgery. American Volume=J Bone Joint Surg Am;;
Journal of Bone and Joint Surgery. British Volume=J Bone Joint Surg Br;;
Journal of Bone and Mineral Research=J Bone Miner Res;;
Journal of Burn Care and Rehabilitation=J Burn Care Rehabil;;
Journal / Canadian Dental Association. Journal de L Association Dentaire Canadienne=J Can Dent Assoc;;
Journal of Cancer Education=J Cancer Educ;;
Journal of Cancer Research and Clinical Oncology=J Cancer Res Clin Oncol;;
Journal of Capillary Electrophoresis=J Capillary Electrophor;;
Journal of Cardiac Failure=J Card Fail;;
Journal of Cardiac Surgery=J Card Surg;;
Journal of Cardiology=J Cardiol;;
Journal of Cardiopulmonary Rehabilitation=J Cardiopulm Rehabil;;
Journal of Cardiothoracic and Vascular Anesthesia=J Cardiothorac Vasc Anesth;;
Journal of Cardiovascular Electrophysiology=J Cardiovasc Electrophysiol;;
Journal of Cardiovascular Nursing=J Cardiovasc Nurs;;
Journal of Cardiovascular Pharmacology=J Cardiovasc Pharmacol;;
Journal of Cardiovascular Risk=J Cardiovasc Risk;;
Journal of Cardiovascular Surgery=J Cardiovasc Surg (Torino);;
Journal of Cataract and Refractive Surgery=J Cataract Refract Surg;;
Journal of Cell Biology=J Cell Biol;;
Journal of Cell Science=J Cell Sci;;
Journal of Cell Science. Supplement=J Cell Sci Suppl;;
Journal of Cellular Biochemistry=J Cell Biochem;;
Journal of Cellular Biochemistry. Supplement=J Cell Biochem Suppl;;
Journal of Cellular Physiology=J Cell Physiol;;
Journal of Cerebral Blood Flow and Metabolism=J Cereb Blood Flow Metab;;
Journal of Chemical Information and Computer Sciences=J Chem Inf Comput Sci;;
Journal of Chemical Neuroanatomy=J Chem Neuroanat;;
Journal of Chemotherapy=J Chemother;;
Journal of Child and Adolescent Psychopharmacology=J Child Adolesc Psychopharmacol;;
Journal of Child Neurology=J Child Neurol;;
Journal of Child Psychology and Psychiatry And Allied Disciplines=J Child Psychol Psychiatry;;
Journal de Chirurgie=J Chir (Paris);;
Journal of Chromatographic Science=J Chromatogr Sci;;
Journal of Chromatography. A=J Chromatogr A;;
Journal of Clinical Anesthesia=J Clin Anesth;;
Journal of Clinical Apheresis=J Clin Apheresis;;
Journal of Clinical Child Psychology=J Clin Child Psychol;;
Journal of Clinical Endocrinology and Metabolism=J Clin Endocrinol Metab;;
Journal of Clinical Epidemiology=J Clin Epidemiol;;
Journal of Clinical Ethics=J Clin Ethics;;
Journal of Clinical and Experimental Neuropsychology=J Clin Exp Neuropsychol;;
Journal of Clinical Gastroenterology=J Clin Gastroenterol;;
Journal of Clinical Immunology=J Clin Immunol;;
Journal of Clinical Investigation=J Clin Invest;;
Journal of Clinical Laboratory Analysis=J Clin Lab Anal;;
Journal of Clinical and Laboratory Immunology=J Clin Lab Immunol;;
Journal of Clinical Microbiology=J Clin Microbiol;;
Journal of Clinical Neurophysiology=J Clin Neurophysiol;;
Journal of Clinical Oncology=J Clin Oncol;;
Journal of Clinical Pathology=J Clin Pathol;;
Journal of Clinical Periodontology=J Clin Periodontol;;
Journal of Clinical Pharmacology=J Clin Pharmacol;;
Journal of Clinical Pharmacy and Therapeutics=J Clin Pharm Ther;;
Journal of Clinical Psychiatry=J Clin Psychiatry;;
Journal of Clinical Psychology=J Clin Psychol;;
Journal of Clinical Psychopharmacology=J Clin Psychopharmacol;;
Journal of Clinical Ultrasound=J Clin Ultrasound;;
Journal of Communicable Diseases=J Commun Dis;;
Journal of Communication Disorders=J Commun Disord;;
Journal of Community Health=J Community Health;;
Journal of Community Health Nursing=J Community Health Nurs;;
Journal of Comparative Neurology=J Comp Neurol;;
Journal of Comparative Pathology=J Comp Pathol;;
Journal of Comparative Physiology. A, Sensory, Neural, and Behavioral Physiology=J Comp Physiol [A];;
Journal of Comparative Physiology. B, Biochemical, Systemic, And Environmental Physiology=J Comp Physiol [B];;
Journal of Comparative Psychology=J Comp Psychol;;
Journal of Computational Biology=J Comput Biol;;
Journal of Computational Neuroscience=J Comput Neurosci;;
Journal of Computer Assisted Tomography=J Comput Assist Tomogr;;
Journal of Computer-Aided Molecular Design=J Comput Aided Mol Des;;
Journal of Consulting and Clinical Psychology=J Consult Clin Psychol;;
Journal of Contemporary Health Law and Policy=J Contemp Health Law Policy;;
Journal of Craniofacial Genetics and Developmental Biology=J Craniofac Genet Dev Biol;;
Journal of Cranio-Maxillo-Facial Surgery=J Craniomaxillofac Surg;;
Journal of Critical Care=J Crit Care;;
Journal of Cutaneous Pathology=J Cutan Pathol;;
Journal of Dairy Research=J Dairy Res;;
Journal of Dairy Science=J Dairy Sci;;
Journal of Dental Education=J Dent Educ;;
Journal of Dental Research=J Dent Res;;
Journal of Dentistry=J Dent;;
Journal of Dermatological Science=J Dermatol Sci;;
Journal of Dermatology=J Dermatol;;
Journal of Developmental and Behavioral Pediatrics=J Dev Behav Pediatr;;
Journal of Diabetes and Its Complications=J Diabetes Complications;;
Journal of Diarrhoeal Diseases Research=J Diarrhoeal Dis Res;;
Journal of Digital IMAging=J Digit Imaging;;
Journal of Drug Education=J Drug Educ;;
Journal of Drug Targeting=J Drug Target;;
Journal of Economic Entomology=J Econ Entomol;;
Journal of ECT=J ECT;;
Journal of The Egyptian Public Health Association=J Egypt Public Health Assoc;;
Journal of The Egyptian Society Of Parasitology=J Egypt Soc Parasitol;;
Journal of Electrocardiology=J Electrocardiol;;
Journal of Electron Microscopy=J Electron Microsc (Tokyo);;
Journal of Emergency Medicine=J Emerg Med;;
Journal of Endocrinological Investigation=J Endocrinol Invest;;
Journal of Endocrinology=J Endocrinol;;
Journal of Endourology=J Endourol;;
Journal of Endovascular Surgery=J Endovasc Surg;;
Journal of Environmental Pathology, Toxicology and Oncology=J Environ Pathol Toxicol Oncol;;
Journal of Environmental Science and Health. Part B: Pesticides, Food Contaminants, And Agricultural Wastes=J Environ Sci Health B;;
Journal of Enzyme Inhibition=J Enzyme Inhib;;
Journal of Epidemiology=J Epidemiol;;
Journal of Epidemiology and Community Health=J Epidemiol Community Health;;
Journal of Ethnopharmacology=J Ethnopharmacol;;
Journal of Eukaryotic Microbiology=J Eukaryot Microbiol;;
Journal of Evaluation In Clinical Practice=J Eval Clin Pract;;
Journal of The Experimental Analysis Of Behavior=J Exp Anal Behav;;
Journal of Experimental Biology=J Exp Biol;;
Journal of Experimental Child Psychology=J Exp Child Psychol;;
Journal of Experimental and Clinical Cancer Research=J Exp Clin Cancer Res;;
Journal of Experimental Medicine=J Exp Med;;
Journal of Experimental Psychology: Animal Behavior Processes=J Exp Psychol Anim Behav Process;;
Journal of Experimental Psychology: General=J Exp Psychol Gen;;
Journal of Experimental Psychology: Human Perception and Performance=J Exp Psychol Hum Percept Perform;;
Journal of Experimental Psychology. Learning, Memory, and Cognition=J Exp Psychol Learn Mem Cogn;;
Journal of Experimental Therapeutics and Oncology=J Exp Ther Oncol;;
Journal of Experimental Zoology=J Exp Zool;;
Journal of Experimental Zoology. Supplement=J Exp Zool Suppl;;
Journal of Exposure Analysis and Environmental Epidemiology=J Expo Anal Environ Epidemiol;;
Journal of Family Practice=J Fam Pract;;
Journal of The Florida Medical Association=J Fla Med Assoc;;
Journal of Foot and Ankle Surgery=J Foot Ankle Surg;;
Journal of Forensic Sciences=J Forensic Sci;;
Journal of The Formosan Medical Association=J Formos Med Assoc;;
Journal Francais D Ophtalmologie=J Fr Ophtalmol;;
Journal of Gastroenterology=J Gastroenterol;;
Journal of Gastroenterology and Hepatology=J Gastroenterol Hepatol;;
Journal of General Internal Medicine=J Gen Intern Med;;
Journal of General Physiology=J Gen Physiol;;
Journal of General Psychology=J Gen Psychol;;
Journal of General Virology=J Gen Virol;;
Journal of Genetic Psychology=J Genet Psychol;;
Journal of Geriatric Psychiatry and Neurology=J Geriatr Psychiatry Neurol;;
Journal of Glaucoma=J Glaucoma;;
Journal de Gynecologie, Obstetrique Et Biologie De la Reproduction=J Gynecol Obstet Biol Reprod (Paris);;
Journal of Hand Surgery. American Volume=J Hand Surg [Am];;
Journal of Hand Surgery. British Volume=J Hand Surg [Br];;
Journal of Hand Therapy=J Hand Ther;;
Journal of Health Care Finance=J Health Care Finance;;
Journal of Health Care For The Poor and Underserved=J Health Care Poor Underserved;;
Journal of Health Politics, Policy and Law=J Health Polit Policy Law;;
Journal of Health and Social Behavior=J Health Soc Behav;;
Journal of Heart and Lung Transplantation=J Heart Lung Transplant;;
Journal of Heart Valve Disease=J Heart Valve Dis;;
Journal of Helminthology=J Helminthol;;
Journal of Hematotherapy=J Hematother;;
Journal of Hepatology=J Hepatol;;
Journal of Heredity=J Hered;;
Journal Fur Hirnforschung=J Hirnforsch;;
Journal of Histochemistry and Cytochemistry=J Histochem Cytochem;;
Journal of The History Of The Behavioral Sciences=J Hist Behav Sci;;
Journal of The History Of Medicine and Allied Sciences=J Hist Med Allied Sci;;
Journal of Homosexuality=J Homosex;;
Journal of Hospital Infection=J Hosp Infect;;
Journal of Human Ergology=J Hum Ergol (Tokyo);;
Journal of Human Evolution=J Hum Evol;;
Journal of Human Genetics=J Hum Genet;;
Journal of Human Hypertension=J Hum Hypertens;;
Journal of Hypertension=J Hypertens;;
Journal of Hypertension. Supplement=J Hypertens Suppl;;
Journal of Immunoassay=J Immunoassay;;
Journal of Immunological Methods=J Immunol Methods;;
Journal of Immunology=J Immunol;;
Journal of The Indian Medical Association=J Indian Med Assoc;;
Journal of Infection=J Infect;;
Journal of Infectious Diseases=J Infect Dis;;
Journal of Inflammation=J Inflamm;;
Journal of Inherited Metabolic Disease=J Inherit Metab Dis;;
Journal of Inorganic Biochemistry=J Inorg Biochem;;
Journal of Intellectual Disability Research=J Intellect Disabil Res;;
Journal of Interferon and Cytokine Research=J Interferon Cytokine Res;;
Journal of Internal Medicine=J Intern Med;;
Journal of Internal Medicine. Supplement=J Intern Med Suppl;;
Journal of International Medical Research=J Int Med Res;;
Journal of The International Neuropsychological Society=J Int Neuropsychol Soc;;
Journal of Invertebrate Pathology=J Invertebr Pathol;;
Journal of Investigational Allergology and Clinical Immunology=J Investig Allergol Clin Immunol;;
Journal of Investigative Dermatology=J Invest Dermatol;;
Journal of Investigative Medicine=J Investig Med;;
Journal of Investigative Surgery=J Invest Surg;;
Journal of The Kentucky Medical Association=J Ky Med Assoc;;
Journal of Korean Medical Science=J Korean Med Sci;;
Journal of Laboratory and Clinical Medicine=J Lab Clin Med;;
Journal of Laparoendoscopic and Advanced Surgical Techniques. Part A=J Laparoendosc Adv Surg Tech A;;
Journal of Laryngology and Otology=J Laryngol Otol;;
Journal of Laryngology and Otology. Supplement=J Laryngol Otol Suppl;;
Journal of Legal Medicine=J Leg Med;;
Journal of Leukocyte Biology=J Leukoc Biol;;
Journal of Lipid Mediators and Cell Signalling=J Lipid Mediat Cell Signal;;
Journal of Lipid Research=J Lipid Res;;
Journal of The Louisiana State Medical Society=J La State Med Soc;;
Journal of Magnetic Resonance=J Magn Reson;;
Journal of Magnetic Resonance IMAging=J Magn Reson Imaging;;
Journal Des Maladies Vasculaires=J Mal Vasc;;
Journal of Manipulative and Physiological Therapeutics=J Manipulative Physiol Ther;;
Journal of Marital and Family Therapy=J Marital Fam Ther;;
Journal of Mass Spectrometry=J Mass Spectrom;;
Journal of Maternal-Fetal Medicine=J Matern Fetal Med;;
Journal of Mathematical Biology=J Math Biol;;
Journal of The Medical Association Of Georgia=J Med Assoc Ga;;
Journal of The Medical Association Of Thailand=J Med Assoc Thai;;
Journal of Medical and Dental Sciences=J Med Dent Sci;;
Journal of Medical Engineering and Technology=J Med Eng Technol;;
Journal of Medical Entomology=J Med Entomol;;
Journal of Medical Ethics=J Med Ethics;;
Journal of Medical Genetics=J Med Genet;;
Journal of Medical Investigation=J Med Invest;;
Journal Medical Libanais. Lebanese Medical Journal=J Med Liban;;
Journal of Medical Microbiology=J Med Microbiol;;
Journal of Medical Primatology=J Med Primatol;;
Journal of Medical Screening=J Med Screen;;
Journal of Medical Systems=J Med Syst;;
Journal of Medical and Veterinary Mycology=J Med Vet Mycol;;
Journal of Medical Virology=J Med Virol;;
Journal of Medicinal Chemistry=J Med Chem;;
Journal of Medicine=J Med;;
Journal of Medicine and Philosophy=J Med Philos;;
Journal of Membrane Biology=J Membr Biol;;
Journal of Microencapsulation=J Microencapsul;;
Journal of Microscopy=J Microsc;;
Journal of Microwave Power and Electromagnetic Energy=J Microw Power Electromagn Energy;;
Journal of The Mississippi State Medical Association=J Miss State Med Assoc;;
Journal of Molecular Biology=J Mol Biol;;
Journal of Molecular and Cellular Cardiology=J Mol Cell Cardiol;;
Journal of Molecular Endocrinology=J Mol Endocrinol;;
Journal of Molecular Evolution=J Mol Evol;;
Journal of Molecular Graphics and Modelling=J Mol Graph Model;;
Journal of Molecular Medicine=J Mol Med;;
Journal of Molecular Neuroscience=J Mol Neurosci;;
Journal of Molecular Recognition=J Mol Recognit;;
Journal of Morphology=J Morphol;;
Journal of Muscle Research and Cell Motility=J Muscle Res Cell Motil;;
Journal of The National Cancer Institute=J Natl Cancer Inst;;
Journal of The National Cancer Institute. Monographs=J Natl Cancer Inst Monogr;;
Journal of The National Medical Association=J Natl Med Assoc;;
Journal of Natural Products=J Nat Prod;;
Journal of Nephrology=J Nephrol;;
Journal of Nervous and Mental Disease=J Nerv Ment Dis;;
Journal of Neural Transmission=J Neural Transm;;
Journal of Neural Transmission. Supplementum=J Neural Transm Suppl;;
Journal of Neural Transplantation and Plasticity=J Neural Transplant Plast;;
Journal of Neurobiology=J Neurobiol;;
Journal of Neurochemistry=J Neurochem;;
Journal of Neurocytology=J Neurocytol;;
Journal of Neuroendocrinology=J Neuroendocrinol;;
Journal of Neurogenetics=J Neurogenet;;
Journal of Neuroimaging=J Neuroimaging;;
Journal of Neuroimmunology=J Neuroimmunol;;
Journal of Neuroimmunology. Supplement=J Neuroimmunol Suppl;;
Journal of The Neurological Sciences=J Neurol Sci;;
Journal of Neurology=J Neurol;;
Journal of Neurology, Neurosurgery and Psychiatry=J Neurol Neurosurg Psychiatry;;
Journal of Neuro-Oncology=J Neurooncol;;
Journal of Neuro-Ophthalmology=J Neuroophthalmol;;
Journal of Neuropathology and Experimental Neurology=J Neuropathol Exp Neurol;;
Journal of Neurophysiology=J Neurophysiol;;
Journal of Neuropsychiatry and Clinical Neurosciences=J Neuropsychiatry Clin Neurosci;;
Journal of Neuroradiology. Journal de Neuroradiologie=J Neuroradiol;;
Journal of Neuroscience=J Neurosci;;
Journal of Neuroscience Methods=J Neurosci Methods;;
Journal of Neuroscience Nursing=J Neurosci Nurs;;
Journal of Neuroscience Research=J Neurosci Res;;
Journal of Neurosurgery=J Neurosurg;;
Journal of Neurosurgical Anesthesiology=J Neurosurg Anesthesiol;;
Journal of Neurosurgical Sciences=J Neurosurg Sci;;
Journal of Neurotrauma=J Neurotrauma;;
Journal of Neurovirology=J Neurovirol;;
Journal of NIHon University School Of Dentistry=J Nihon Univ Sch Dent;;
Journal of Nuclear Cardiology=J Nucl Cardiol;;
Journal of Nuclear Medicine=J Nucl Med;;
Journal of Nuclear Medicine Technology=J Nucl Med Technol;;
Journal of Nurse-Midwifery=J Nurse Midwifery;;
Journal of Nursing Administration=J Nurs Adm;;
Journal of Nursing Care Quality=J Nurs Care Qual;;
Journal of Nursing Education=J Nurs Educ;;
Journal of Nursing Measurement=J Nurs Meas;;
Journal of Nutrition=J Nutr;;
Journal of Nutritional Science and Vitaminology=J Nutr Sci Vitaminol (Tokyo);;
Journal of Obstetric, Gynecologic, and Neonatal Nursing=J Obstet Gynecol Neonatal Nurs;;
Journal of Obstetrics and Gynaecology Research=J Obstet Gynaecol Res;;
Journal of Occupational and Environmental Medicine=J Occup Environ Med;;
Journal of Ocular Pharmacology and Therapeutics=J Ocul Pharmacol Ther;;
Journal - Oklahoma State Medical Association=J Okla State Med Assoc;;
Journal of The Optical Society Of America A. Optics, IMAge Science, and Vision=J Opt Soc Am A Opt Image Sci Vis;;
Journal of Oral and Maxillofacial Surgery=J Oral Maxillofac Surg;;
Journal of Oral Pathology and Medicine=J Oral Pathol Med;;
Journal of Oral Rehabilitation=J Oral Rehabil;;
Journal of Orthopaedic Research=J Orthop Res;;
Journal of Orthopaedic and Sports Physical Therapy=J Orthop Sports Phys Ther;;
Journal of Orthopaedic Trauma=J Orthop Trauma;;
Journal of Otolaryngology=J Otolaryngol;;
Journal of Paediatrics and Child Health=J Paediatr Child Health;;
Journal of Pain and Symptom Management=J Pain Symptom Manage;;
Journal of Palliative Care=J Palliat Care;;
Journal of Parasitology=J Parasitol;;
Journal of Pathology=J Pathol;;
Journal of Pediatric and Adolescent Gynecology=J Pediatr Adolesc Gynecol;;
Journal of Pediatric Endocrinology and Metabolism=J Pediatr Endocrinol Metab;;
Journal of Pediatric Gastroenterology and Nutrition=J Pediatr Gastroenterol Nutr;;
Journal of Pediatric Hematology/Oncology=J Pediatr Hematol Oncol;;
Journal of Pediatric Nursing=J Pediatr Nurs;;
Journal of Pediatric Oncology Nursing=J Pediatr Oncol Nurs;;
Journal of Pediatric Ophthalmology and Strabismus=J Pediatr Ophthalmol Strabismus;;
Journal of Pediatric Orthopaedics. Part B=J Pediatr Orthop B;;
Journal of Pediatric Orthopedics=J Pediatr Orthop;;
Journal of Pediatric Psychology=J Pediatr Psychol;;
Journal of Pediatric Surgery=J Pediatr Surg;;
Journal of Pediatrics=J Pediatr;;
Journal of Peptide Research=J Pept Res;;
Journal of Peptide Science=J Pept Sci;;
Journal of Perinatal Medicine=J Perinat Med;;
Journal of Perinatology=J Perinatol;;
Journal of Periodontal Research=J Periodontal Res;;
Journal of Periodontology=J Periodontol;;
Journal of Personality=J Pers;;
Journal of Personality Assessment=J Pers Assess;;
Journal of Personality Disorders=J Personal Disord;;
Journal of Personality and Social Psychology=J Pers Soc Psychol;;
Journal of Pharmaceutical and Biomedical Analysis=J Pharm Biomed Anal;;
Journal of Pharmaceutical Sciences=J Pharm Sci;;
Journal de Pharmacie De Belgique=J Pharm Belg;;
Journal of Pharmacokinetics and Biopharmaceutics=J Pharmacokinet Biopharm;;
Journal of Pharmacological and Toxicological Methods=J Pharmacol Toxicol Methods;;
Journal of Pharmacology and Experimental Therapeutics=J Pharmacol Exp Ther;;
Journal of Pharmacy and Pharmacology=J Pharm Pharmacol;;
Journal of Photochemistry and Photobiology. B, Biology=J Photochem Photobiol B;;
Journal of Physiology=J Physiol (Lond);;
Journal of Physiology, Paris=J Physiol Paris;;
Journal of Physiology and Pharmacology=J Physiol Pharmacol;;
Journal of Pineal Research=J Pineal Res;;
Journal of Postgraduate Medicine=J Postgrad Med;;
Journal of Professional Nursing=J Prof Nurs;;
Journal of Prosthetic Dentistry=J Prosthet Dent;;
Journal of Protein Chemistry=J Protein Chem;;
Journal of Psychiatric Research=J Psychiatr Res;;
Journal of Psychiatry and Neuroscience=J Psychiatry Neurosci;;
Journal of Psychoactive Drugs=J Psychoactive Drugs;;
Journal of Psycholinguistic Research=J Psycholinguist Res;;
Journal of Psychology=J Psychol;;
Journal of Psychopharmacology=J Psychopharmacol (Oxf);;
Journal of Psychosocial Nursing and Mental Health Services=J Psychosoc Nurs Ment Health Serv;;
Journal of Psychosomatic Obstetrics and Gynaecology=J Psychosom Obstet Gynaecol;;
Journal of Psychosomatic Research=J Psychosom Res;;
Journal of Psychotherapy Practice and Research=J Psychother Pract Res;;
Journal of Public Health Dentistry=J Public Health Dent;;
Journal of Public Health Medicine=J Public Health Med;;
Journal of Public Health Policy=J Public Health Policy;;
Journal of Quality In Clinical Practice=J Qual Clin Pract;;
Journal of Radiation Research=J Radiat Res (Tokyo);;
Journal of Radiological Protection=J Radiol Prot;;
Journal de Radiologie=J Radiol;;
Journal of Receptor and Signal Transduction Research=J Recept Signal Transduct Res;;
Journal of Reconstructive Microsurgery=J Reconstr Microsurg;;
Journal of Refractive Surgery=J Refract Surg;;
Journal of Rehabilitation Research and Development=J Rehabil Res Dev;;
Journal of Reproduction and Fertility=J Reprod Fertil;;
Journal of Reproduction and Fertility. Abstract Series=J Reprod Fertil Abstr Ser;;
Journal of Reproduction and Fertility. Supplement=J Reprod Fertil Suppl;;
Journal of Reproductive Immunology=J Reprod Immunol;;
Journal of Reproductive Medicine=J Reprod Med;;
Journal of Rheumatology=J Rheumatol;;
Journal of Rheumatology. Supplement=J Rheumatol Suppl;;
Journal of The Royal Army Medical Corps=J R Army Med Corps;;
Journal of The Royal College Of Physicians Of London=J R Coll Physicians Lond;;
Journal of The Royal College Of Surgeons Of Edinburgh=J R Coll Surg Edinb;;
Journal of The Royal Naval Medical Service=J R Nav Med Serv;;
Journal of The Royal Society Of Health=J R Soc Health;;
Journal of The Royal Society Of Medicine=J R Soc Med;;
Journal of School Health=J Sch Health;;
Journal of Sex and Marital Therapy=J Sex Marital Ther;;
Journal of Shoulder and Elbow Surgery=J Shoulder Elbow Surg;;
Journal of Sleep Research=J Sleep Res;;
Journal of Small Animal Practice=J Small Anim Pract;;
Journal of Smooth Muscle Research (Hirosaki-Shi=J Smooth Muscle Res;;
Journal of Social Psychology=J Soc Psychol;;
Journal of The Society For Gynecologic Investigation=J Soc Gynecol Investig;;
Journal of The Society For Health Systems=J Soc Health Syst;;
Journal of The Society Of Pediatric Nurses=J Soc Pediatr Nurs;;
Journal of The South African Veterinary Association=J S Afr Vet Assoc;;
Journal - South Carolina Medical Association=J S C Med Assoc;;
Journal of The Southern Orthopaedic Association=J South Orthop Assoc;;
Journal of Speech, Language, and Hearing Research=J Speech Lang Hear Res;;
Journal of Spinal Cord Medicine=J Spinal Cord Med;;
Journal of Spinal Disorders=J Spinal Disord;;
Journal of Sports Medicine and Physical Fitness=J Sports Med Phys Fitness;;
Journal of Sports Sciences=J Sports Sci;;
Journal of Steroid Biochemistry and Molecular Biology=J Steroid Biochem Mol Biol;;
Journal of Structural Biology=J Struct Biol;;
Journal of Studies on Alcohol=J Stud Alcohol;;
Journal of Studies on Alcohol. Supplement=J Stud Alcohol Suppl;;
Journal of Submicroscopic Cytology and Pathology=J Submicrosc Cytol Pathol;;
Journal of Substance Abuse=J Subst Abuse;;
Journal of Substance Abuse Treatment=J Subst Abuse Treat;;
Journal of Surgical Oncology=J Surg Oncol;;
Journal of Surgical Oncology. Supplement=J Surg Oncol Suppl;;
Journal of Surgical Research=J Surg Res;;
Journal of Telemedicine and Telecare=J Telemed Telecare;;
Journal of Theoretical Biology=J Theor Biol;;
Journal of Thoracic and Cardiovascular Surgery=J Thorac Cardiovasc Surg;;
Journal of Tongji Medical University=J Tongji Med Univ;;
Journal of Toxicological Sciences=J Toxicol Sci;;
Journal of Toxicology. Clinical Toxicology=J Toxicol Clin Toxicol;;
Journal of Toxicology and Environmental Health=J Toxicol Environ Health;;
Journal of Trace Elements In Medicine and Biology=J Trace Elem Med Biol;;
Journal of Traditional Chinese Medicine=J Tradit Chin Med;;
Journal of Trauma=J Trauma;;
Journal of Traumatic Stress=J Trauma Stress;;
Journal of Tropical Pediatrics=J Trop Pediatr;;
Journal of Ultrasound In Medicine=J Ultrasound Med;;
Journal of Urology=J Urol;;
Journal of Vascular and Interventional Radiology=J Vasc Interv Radiol;;
Journal of Vascular Research=J Vasc Res;;
Journal of Vascular Surgery=J Vasc Surg;;
Journal of Vector Ecology=J Vector Ecol;;
Journal of Vestibular Research=J Vestib Res;;
Journal of Veterinary Diagnostic Investigation=J Vet Diagn Invest;;
Journal of Veterinary Internal Medicine=J Vet Intern Med;;
Journal of Veterinary Medical Science=J Vet Med Sci;;
Journal of Veterinary Pharmacology and Therapeutics=J Vet Pharmacol Ther;;
Journal of Viral Hepatitis=J Viral Hepat;;
Journal of Virological Methods=J Virol Methods;;
Journal of Virology=J Virol;;
Journal of Voice=J Voice;;
Journal of Wildlife Diseases=J Wildl Dis;;
Journal of Womens Health=J Womens Health;;
Journal of Zoo and Wildlife Medicine=J Zoo Wildl Med;;
Journals of Gerontology. Series A, Biological Sciences And Medical Sciences=J Gerontol A Biol Sci Med Sci;;
Journals of Gerontology. Series B, Psychological Sciences And Social Sciences=J Gerontol B Psychol Sci Soc Sci;;
Journees Annuelles de Diabetologie De L Hotel-Dieu=Journ Annu Diabetol Hotel Dieu;;
JPEN. Journal of Parenteral and Enteral Nutrition=JPEN J Parenter Enteral Nutr;;
JPMA. Journal of The Pakistan Medical Association=JPMA J Pak Med Assoc;;
Kaibogaku Zasshi. Journal of Anatomy=Kaibogaku Zasshi;;
Kaku Igaku [Japanese Journal of Nuclear Medicine]=Kaku Igaku;;
Kansas Medicine=Kans Med;;
Kansenshogaku Zasshi. Journal of The Japanese Association ForInfectious Diseases=Kansenshogaku Zasshi;;
Kao-Hsiung I Hsueh Ko Hsueh Tsa Chih [Kaohsiung Journal Of Medical Sciences]=Kao Hsiung I Hsueh Ko Hsueh Tsa Chih;;
Keio Journal of Medicine=Keio J Med;;
Kekkaku=Kekkaku;;
Khirurgiia=Khirurgiia (Sofiia);;
Khirurgiia=Khirurgiia (Mosk);;
Kidney and Blood Pressure Research=Kidney Blood Press Res;;
Kidney International=Kidney Int;;
Kidney International. Supplement=Kidney Int Suppl;;
Klinicheskaia Laboratornaia Diagnostika=Klin Lab Diagn;;
Klinicheskaia Meditsina=Klin Med (Mosk);;
Klinika Oczna=Klin Oczna;;
Klinische Anasthesiologie Und Intensivtherapie=Klin Anasthesiol Intensivther;;
Klinische Monatsblatter Fur Augenheilkunde=Klin Monatsbl Augenheilkd;;
Klinische Padiatrie=Klin Padiatr;;
Knee Surgery, Sports Traumatology, Arthroscopy=Knee Surg Sports Traumatol Arthrosc;;
Kobe Journal of Medical Sciences=Kobe J Med Sci;;
Kokubyo Gakkai Zasshi. The Journal of The Stomatological Society, Japan=Kokubyo Gakkai Zasshi;;
Korean Journal of Ophthalmology=Korean J Ophthalmol;;
Korean Journal of Parasitology=Korean J Parasitol;;
Kuang Pu Hseuh Yu Kuang Pu Fen Hsi Spectroscopy and Spectral Analysis (Pei-Ching=Kuang Pu Hseuh Yu Kuang Pu Fen Hsi;;
Kurume Medical Journal=Kurume Med J;;
Kyobu Geka. Japanese Journal of Thoracic Surgery=Kyobu Geka;;
Laboratory Animal Science=Lab Anim Sci;;
Laboratory Animals=Lab Anim;;
Laboratory Investigation=Lab Invest;;
Lakartidningen=Lakartidningen;;
Lancet=Lancet;;
Langenbecks Archiv Fur Chirurgie. Supplement. Kongressband=Langenbecks Arch Chir Suppl Kongressbd;;
Langenbecks Archive of Surgery=Langenbecks Arch Surg;;
Language and Communication Disorders=Lang Commun Disord;;
Language and Speech=Lang Speech;;
Laryngo- Rhino- Otologie=Laryngorhinootologie;;
Laryngoscope=Laryngoscope;;
Lasers In Surgery and Medicine=Lasers Surg Med;;
Lasers In Surgery and Medicine. Supplement=Lasers Surg Med Suppl;;
Law and Human Behavior=Law Hum Behav;;
Leprosy Review=Lepr Rev;;
Leukemia=Leukemia;;
Leukemia and Lymphoma=Leuk Lymphoma;;
Leukemia Research=Leuk Res;;
Life Sciences=Life Sci;;
Lifetime Data Analysis=Lifetime Data Anal;;
Lijecnicki Vjesnik=Lijec Vjesn;;
Likarska Sprava=Lik Sprava;;
Lin Chuang Erh Pi Yen Hou Ko Tsa Chih Journal of Clinical Otorhinolaryngology (Wu-Han Shih=Lin Chuang Erh Pi Yen Hou Ko Tsa Chih;;
Lipids=Lipids;;
Literature and Medicine=Lit Med;;
Liver=Liver;;
Liver Transplantation and Surgery=Liver Transpl Surg;;
Lung=Lung;;
Lung Cancer=Lung Cancer;;
Lupus=Lupus;;
Lymphology=Lymphology;;
MAGMA=MAGMA;;
Magnesium Research=Magnes Res;;
Magnetic Resonance IMAging=Magn Reson Imaging;;
Magnetic Resonance IMAging Clinics of North America=Magn Reson Imaging Clin N Am;;
Magnetic Resonance In Medicine=Magn Reson Med;;
Malaysian Journal of Pathology=Malays J Pathol;;
Mammalian Genome=Mamm Genome;;
Maryland Medical Journal=Md Med J;;
MASA Review=MASA Rev;;
Mass Spectrometry Reviews=Mass Spectrom Rev;;
Masui. Japanese Journal of Anesthesiology=Masui;;
Materia Medica Polona=Mater Med Pol;;
Mathematical Biosciences=Math Biosci;;
Matrix Biology=Matrix Biol;;
Maturitas=Maturitas;;
Mayo Clinic Proceedings=Mayo Clin Proc;;
MCN; American Journal of Maternal Child Nursing=MCN Am J Matern Child Nurs;;
Md Computing=MD Comput;;
Mechanisms of Ageing and Development=Mech Ageing Dev;;
Mechanisms of Development=Mech Dev;;
Medecine Tropicale=Med Trop (Mars);;
Medical Anthropology=Med Anthropol;;
Medical Anthropology Quarterly=Med Anthropol Q;;
Medical and Biological Engineering And Computing=Med Biol Eng Comput;;
Medical Care=Med Care;;
Medical Clinics of North America=Med Clin North Am;;
Medical Decision Making=Med Decis Making;;
Medical Dosimetry=Med Dosim;;
Medical Education=Med Educ;;
Medical Engineering and Physics=Med Eng Phys;;
Medical History=Med Hist;;
Medical History. Supplement=Med Hist Suppl;;
Medical Hypotheses=Med Hypotheses;;
Medical Informatics=Med Inf (Lond);;
Medical Journal of Australia=Med J Aust;;
Medical Journal of Malaysia=Med J Malaysia;;
Medical Journal of Osaka University=Med J Osaka Univ;;
Medical Letter on Drugs and Therapeutics=Med Lett Drugs Ther;;
Medical Microbiology and Immunology=Med Microbiol Immunol (Berl);;
Medical Oncology=Med Oncol;;
Medical and Pediatric Oncology=Med Pediatr Oncol;;
Medical and Pediatric Oncology. Supplement=Med Pediatr Oncol Suppl;;
Medical Physics=Med Phys;;
Medical Progress Through Technology=Med Prog Technol;;
Medical and Veterinary Entomology=Med Vet Entomol;;
Medicina=Medicina (B Aires);;
Medicina Clinica=Med Clin (Barc);;
Medicina Interna=Med Interna;;
Medicina Del Lavoro=Med Lav;;
Medicinal Research Reviews=Med Res Rev;;
Medicine=Medicine (Baltimore);;
Medicine, Conflict and Survival=Med Confl Surviv;;
Medicine and Health, Rhode Island=Med Health R I;;
Medicine and Law=Med Law;;
Medicine, Science and The Law=Med Sci Law;;
Medicine and Science In Sports And Exercise=Med Sci Sports Exerc;;
Medicinski Arhiv=Med Arh;;
Medicinski Pregled=Med Pregl;;
Medico-Legal Journal=Med Leg J;;
Meditsinskaia Parazitologiia I Parazitarnye Bolezni=Med Parazitol (Mosk);;
Meditsinskaia Tekhnika=Med Tekh;;
Medizinhistorisches Journal=Medizinhist J;;
Medizinische Klinik=Med Klin;;
Medizinische Monatsschrift Fur Pharmazeuten=Med Monatsschr Pharm;;
Medycyna Doswiadczalna I Mikrobiologia=Med Dosw Mikrobiol;;
Medycyna Pracy=Med Pr;;
Melanoma Research=Melanoma Res;;
Membrane and Cell Biology=Membr Cell Biol;;
Memorias Do Instituto Oswaldo Cruz=Mem Inst Oswaldo Cruz;;
Memory=Memory;;
Mental Health Statistical Note=Ment Health Stat Note;;
Mental and Physical Disability Law Reporter=Ment Phys Disabil Law Rep;;
Mental Retardation=Ment Retard;;
Metabolic Brain Disease=Metab Brain Dis;;
Metabolic, Pediatric, and Systemic Ophthalmology=Metab Pediatr Syst Ophthalmol;;
Metabolism: Clinical and Experimental=Metabolism;;
Metal Ions In Biological Systems=Met Ions Biol Syst;;
Methods=Methods;;
Methods of Biochemical Analysis=Methods Biochem Anal;;
Methods In Cell Biology=Methods Cell Biol;;
Methods In Enzymology=Methods Enzymol;;
Methods and Findings In Experimental And Clinical Pharmacology=Methods Find Exp Clin Pharmacol;;
Methods of Information In Medicine=Methods Inf Med;;
Methods In Molecular Biology=Methods Mol Biol;;
Michigan Medicine=Mich Med;;
Microbial Drug Resistance=Microb Drug Resist;;
Microbial Pathogenesis=Microb Pathog;;
Microbiologia=Microbiologia;;
Microbiological Research=Microbiol Res;;
Microbiology=Microbiology;;
Microbiology and Immunology=Microbiol Immunol;;
Microbiology and Molecular Biology Reviews=Microbiol Mol Biol Rev;;
Microbios=Microbios;;
Microcirculation=Microcirculation;;
Micron=Micron;;
Microscopy Research and Technique=Microsc Res Tech;;
Microsurgery=Microsurgery;;
Microvascular Research=Microvasc Res;;
Middle East Journal of Anesthesiology=Middle East J Anesthesiol;;
Mikrobiologiia=Mikrobiologiia;;
Mikrobiolohichnyi Zhurnal=Mikrobiol Z;;
Milbank Quarterly=Milbank Q;;
Military Medicine=Mil Med;;
Mineral and Electrolyte Metabolism=Miner Electrolyte Metab;;
Minerva Anestesiologica=Minerva Anestesiol;;
Minerva Cardioangiologica=Minerva Cardioangiol;;
Minerva Chirurgica=Minerva Chir;;
Minerva Endocrinologica=Minerva Endocrinol;;
Minerva Ginecologica=Minerva Ginecol;;
Minerva Medica=Minerva Med;;
Minerva Pediatrica=Minerva Pediatr;;
Minerva Stomatologica=Minerva Stomatol;;
Minerva Urologica E Nefrologica=Minerva Urol Nefrol;;
Minimally Invasive Neurosurgery=Minim Invasive Neurosurg;;
Minnesota Medicine=Minn Med;;
Missouri Medicine=Mo Med;;
MMWR Cdc Surveillance Summaries=MMWR CDC Surveill Summ;;
MMWR. Morbidity and Mortality Weekly Report=MMWR Morb Mortal Wkly Rep;;
Modern Pathology=Mod Pathol;;
Modern Problems of Pharmacopsychiatry=Mod Probl Pharmacopsychiatry;;
Molecular Aspects of Medicine=Mol Aspects Med;;
Molecular and Biochemical Parasitology=Mol Biochem Parasitol;;
Molecular Biology of The Cell=Mol Biol Cell;;
Molecular Biology and Evolution=Mol Biol Evol;;
Molecular Biology Reports=Mol Biol Rep;;
Molecular Biotechnology=Mol Biotechnol;;
Molecular Carcinogenesis=Mol Carcinog;;
Molecular and Cellular Biochemistry=Mol Cell Biochem;;
Molecular and Cellular Biology=Mol Cell Biol;;
Molecular and Cellular Endocrinology=Mol Cell Endocrinol;;
Molecular and Cellular Neurosciences=Mol Cell Neurosci;;
Molecular and Cellular Probes=Mol Cell Probes;;
Molecular and Chemical Neuropathology=Mol Chem Neuropathol;;
Molecular Diversity=Mol Divers;;
Molecular Ecology=Mol Ecol;;
Molecular Endocrinology=Mol Endocrinol;;
Molecular and General Genetics=Mol Gen Genet;;
Molecular Genetics and Metabolism=Mol Genet Metab;;
Molecular Human Reproduction=Mol Hum Reprod;;
Molecular Immunology=Mol Immunol;;
Molecular Marine Biology and Biotechnology=Mol Mar Biol Biotechnol;;
Molecular Medicine=Mol Med;;
Molecular Medicine Today=Mol Med Today;;
Molecular Membrane Biology=Mol Membr Biol;;
Molecular Microbiology=Mol Microbiol;;
Molecular Neurobiology=Mol Neurobiol;;
Molecular Pathology=Mol Pathol;;
Molecular Pharmacology=Mol Pharmacol;;
Molecular Phylogenetics and Evolution=Mol Phylogenet Evol;;
Molecular Plant-Microbe Interactions=Mol Plant Microbe Interact;;
Molecular Psychiatry=Mol Psychiatry;;
Molecular Reproduction and Development=Mol Reprod Dev;;
Molecular Vision=Mol Vis;;
Molecules and Cells=Mol Cells;;
Molekuliarna Meditsina=Mol Med (Sofia);;
Molekuliarnaia Biologiia=Mol Biol (Mosk);;
Molekuliarnaia Genetika, Mikrobiologia, I Virusologa=Mol Gen Mikrobiol Virusol;;
Monaldi Archives For Chest Disease=Monaldi Arch Chest Dis;;
Monographs In Allergy=Monogr Allergy;;
Monographs In Clinical Cytology=Monogr Clin Cytol;;
Monographs on Endocrinology=Monogr Endocrinol;;
Monographs In Oral Science=Monogr Oral Sci;;
Monographs In Pathology=Monogr Pathol;;
Monographs of The Society For Research In Child Development=Monogr Soc Res Child Dev;;
Monthly Vital Statistics Report=Mon Vital Stat Rep;;
Morfologiia (Sankt-Peterburg=Morfologiia;;
Mount Sinai Journal of Medicine=Mt Sinai J Med;;
Movement Disorders=Mov Disord;;
Multiple Sclerosis=Mult Scler;;
Mund-, Kiefer- Und Gesichtschirurgie=Mund Kiefer Gesichtschir;;
Muscle and Nerve=Muscle Nerve;;
Mutagenesis=Mutagenesis;;
Mutation Research=Mutat Res;;
Mycopathologia=Mycopathologia;;
Mycoses=Mycoses;;
Nagoya Journal of Medical Science=Nagoya J Med Sci;;
Nahrung=Nahrung;;
National Medical Journal of India=Natl Med J India;;
Natural Immunity=Nat Immun;;
Natural Product Reports=Nat Prod Rep;;
Natural Toxins=Nat Toxins;;
Nature=Nature;;
Nature Biotechnology=Nat Biotechnol;;
Nature Genetics=Nat Genet;;
Nature Medicine=Nat Med;;
Nature Structural Biology=Nat Struct Biol;;
Naturwissenschaften=Naturwissenschaften;;
Naunyn-Schmiedebergs Archives of Pharmacology=Naunyn Schmiedebergs Arch Pharmacol;;
Nebraska Symposium on Motivation=Nebr Symp Motiv;;
Nederlands Tijdschrift Voor Geneeskunde=Ned Tijdschr Geneeskd;;
Neoplasma=Neoplasma;;
Nephrologie=Nephrologie;;
Nephrology, Dialysis, Transplantation=Nephrol Dial Transplant;;
Nephron=Nephron;;
Nervenarzt=Nervenarzt;;
Netherlands Journal of Medicine=Neth J Med;;
Neural Computation=Neural Comput;;
Neurobiology=Neurobiology (Bp);;
Neurobiology of Aging=Neurobiol Aging;;
Neurobiology of Disease=Neurobiol Dis;;
Neurobiology of Learning and Memory=Neurobiol Learn Mem;;
Neurochemical Research=Neurochem Res;;
Neurochemistry International=Neurochem Int;;
Neuro-Chirurgie=Neurochirurgie;;
Neuroendocrinology=Neuroendocrinology;;
Neuroepidemiology=Neuroepidemiology;;
Neurogastroenterology and Motility=Neurogastroenterol Motil;;
Neuroimage=Neuroimage;;
Neuroimaging Clinics of North America=Neuroimaging Clin N Am;;
Neuroimmunomodulation=Neuroimmunomodulation;;
Neurologia=Neurologia;;
Neurologia Medico-Chirurgica=Neurol Med Chir (Tokyo);;
Neurologia I Neurochirurgia Polska=Neurol Neurochir Pol;;
Neurologic Clinics=Neurol Clin;;
Neurological Research=Neurol Res;;
Neurology=Neurology;;
Neuromuscular Disorders=Neuromuscul Disord;;
Neuron=Neuron;;
Neuropathology and Applied Neurobiology=Neuropathol Appl Neurobiol;;
Neuropediatrics=Neuropediatrics;;
Neuropeptides=Neuropeptides;;
Neuropharmacology=Neuropharmacology;;
Neurophysiologie Clinique=Neurophysiol Clin;;
Neuropsychiatry, Neuropsychology, and Behavioral Neurology=Neuropsychiatry Neuropsychol Behav Neurol;;
Neuropsychobiology=Neuropsychobiology;;
Neuropsychologia=Neuropsychologia;;
Neuropsychology=Neuropsychology;;
Neuropsychology Review=Neuropsychol Rev;;
Neuropsychopharmacology=Neuropsychopharmacology;;
Neuroradiology=Neuroradiology;;
Neuroreport=Neuroreport;;
Neuroscience=Neuroscience;;
Neuroscience and Behavioral Physiology=Neurosci Behav Physiol;;
Neuroscience and Biobehavioral Reviews=Neurosci Biobehav Rev;;
Neuroscience Letters=Neurosci Lett;;
Neuroscience Letters. Supplement=Neurosci Lett Suppl;;
Neuroscience Research=Neurosci Res;;
Neuroscience Research. Supplement=Neurosci Res Suppl;;
Neurosurgery=Neurosurgery;;
Neurosurgery Clinics of North America=Neurosurg Clin N Am;;
Neurosurgical Review=Neurosurg Rev;;
Neurotoxicology=Neurotoxicology;;
Neurotoxicology and Teratology=Neurotoxicol Teratol;;
Neurotoxins=Neurotoxins;;
Neurourology and Urodynamics=Neurourol Urodyn;;
New Directions For Child Development=New Dir Child Dev;;
New Directions For Mental Health Services=New Dir Ment Health Serv;;
New England Journal of Medicine=N Engl J Med;;
New Horizons=New Horiz;;
New Jersey Medicine=N J Med;;
New Microbiologica=New Microbiol;;
New York State Dental Journal=N Y State Dent J;;
New Zealand Dental Journal=N Z Dent J;;
New Zealand Medical Journal=N Z Med J;;
NIDA Research Monograph=NIDA Res Monogr;;
NIH Consensus Statement=NIH Consens Statement;;
NIH Guide For Grants and Contracts=NIH Guide Grants Contracts;;
NIHon Arukoru Yakubutsu Igakkai Zasshi=Nihon Arukoru Yakubutsu Igakkai Zasshi;;
NIHon Hansenbyo Gakkai Zasshi. Japanese Journal of Leprosy (Higashimurayama- Shi=Nihon Hansenbyo Gakkai Zasshi;;
NIHon Rinsho Meneki Gakkai Kaishi=Nihon Rinsho Meneki Gakkai Kaishi;;
NIHon Shinkei Seishin Yakurigaku Zasshi (Kawasaki-Shi=Nihon Shinkei Seishin Yakurigaku Zasshi;;
Nippon Eiseigaku Zasshi. Japanese Journal of Hygiene=Nippon Eiseigaku Zasshi;;
Nippon Ganka Gakkai Zasshi. Acta Societatis Ophthalmologicae Japonicae=Nippon Ganka Gakkai Zasshi;;
Nippon Geka Gakkai Zasshi. Journal of Japan Surgical Society=Nippon Geka Gakkai Zasshi;;
Nippon Geka Hokan. Archiv Fur Japanische Chirurgie=Nippon Geka Hokan;;
Nippon Hinyokika Gakkai Zasshi. Japanese Journal of Urology=Nippon Hinyokika Gakkai Zasshi;;
Nippon Hoigaku Zasshi. Japanese Journal of Legal Medicine=Nippon Hoigaku Zasshi;;
Nippon Igaku Hoshasen Gakkai Zasshi. Nippon Acta Radiologica=Nippon Igaku Hoshasen Gakkai Zasshi;;
Nippon Ika Daigaku Zasshi. Journal of The Nippon Medical School=Nippon Ika Daigaku Zasshi;;
Nippon Jibiinkoka Gakkai Kaiho [Journal of The Oto-Rhino-Laryngological Society Of Japan]=Nippon Jibiinkoka Gakkai Kaiho;;
Nippon Jinzo Gakkai Shi. Japanese Journal of Nephrology=Nippon Jinzo Gakkai Shi;;
Nippon Koshu Eisei Zasshi [Japanese Journal of Public Health]=Nippon Koshu Eisei Zasshi;;
Nippon Kyobu Geka Gakkai Zasshi. Journal of The Japanese Association For Thoracic Surgery=Nippon Kyobu Geka Gakkai Zasshi;;
Nippon Kyobu Shikkan Gakkai Zasshi. Japanese Journal of Thoracic Diseases=Nippon Kyobu Shikkan Gakkai Zasshi;;
Nippon Naika Gakkai Zasshi. Journal of Japanese Society Of Internal Medicine=Nippon Naika Gakkai Zasshi;;
Nippon Rinsho. Japanese Journal of Clinical Medicine=Nippon Rinsho;;
Nippon Ronen Igakkai Zasshi. Japanese Journal of Geriatrics=Nippon Ronen Igakkai Zasshi;;
Nippon Saikingaku Zasshi. Japanese Journal of Bacteriology=Nippon Saikingaku Zasshi;;
Nippon Seirigaku Zasshi. Journal of The Physiological Society Of Japan=Nippon Seirigaku Zasshi;;
Nippon Shokakibyo Gakkai Zasshi. Japanese Journal of Gastroenterology=Nippon Shokakibyo Gakkai Zasshi;;
Nippon Yakurigaku Zasshi. Folia Pharmacologica Japonica=Nippon Yakurigaku Zasshi;;
NMR In Biomedicine=NMR Biomed;;
No Shinkei Geka. Neurological Surgery=No Shinkei Geka;;
No To Hattatsu [Brain and Development]=No To Hattatsu;;
No To Shinkei. Brain and Nerve=No To Shinkei;;
Nordisk Medicin=Nord Med;;
North Carolina Medical Journal (Relston-Salem Nc=N C Med J;;
Nuclear Medicine and Biology=Nucl Med Biol;;
Nuclear Medicine Communications=Nucl Med Commun;;
Nucleic Acids Research=Nucleic Acids Res;;
Nucleic Acids Symposium Series=Nucleic Acids Symp Ser;;
Nuklearmedizin=Nuklearmedizin;;
Nurse Practitioner=Nurse Pract;;
Nursing Clinics of North America=Nurs Clin North Am;;
Nursing History Review=Nurs Hist Rev;;
Nursing Outlook=Nurs Outlook;;
Nursing Research=Nurs Res;;
Nutricion Hospitalaria=Nutr Hosp;;
Nutrition=Nutrition;;
Nutrition and Cancer=Nutr Cancer;;
Nutrition and Health=Nutr Health;;
Nutrition Reviews=Nutr Rev;;
Obesity Research=Obes Res;;
Obstetrical and Gynecological Survey=Obstet Gynecol Surv;;
Obstetrics and Gynecology=Obstet Gynecol;;
Obstetrics and Gynecology Clinics of North America=Obstet Gynecol Clin North Am;;
Occupational and Environmental Medicine=Occup Environ Med;;
Occupational Health and Safety=Occup Health Saf;;
Occupational Medicine=Occup Med (Oxf);;
Occupational Medicine=Occup Med;;
Ocular Immunology and Inflammation=Ocul Immunol Inflamm;;
Oftalmologia=Oftalmologia;;
Okajimas Folia Anatomica Japonica=Okajimas Folia Anat Jpn;;
Oncogene=Oncogene;;
Oncology=Oncology (Huntingt);;
Oncology=Oncology;;
Oncology Nursing Forum=Oncol Nurs Forum;;
Oncology Research=Oncol Res;;
Onderstepoort Journal of Veterinary Research=Onderstepoort J Vet Res;;
Online Journal of Current Clinical Trials=Online J Curr Clin Trials;;
Ontogenez=Ontogenez;;
Ophthalmic Epidemiology=Ophthalmic Epidemiol;;
Ophthalmic Genetics=Ophthalmic Genet;;
Ophthalmic and Physiological Optics=Ophthalmic Physiol Opt;;
Ophthalmic Plastic and Reconstructive Surgery=Ophthal Plast Reconstr Surg;;
Ophthalmic Research=Ophthalmic Res;;
Ophthalmic Surgery and Lasers=Ophthalmic Surg Lasers;;
Ophthalmologe=Ophthalmologe;;
Ophthalmologica=Ophthalmologica;;
Ophthalmology=Ophthalmology;;
Optometry and Vision Science=Optom Vis Sci;;
Oral Surgery, Oral Medicine, Oral Pathology, Oral Radiology AndEndodontics Oral Surg Oral Med Oral Pathol Oral Radio=Endod;;
Origins of Life and Evolution Of The Biosphere=Orig Life Evol Biosph;;
Orl; Journal of Oto-Rhino-Laryngology and Its Related Specialties=ORL J Otorhinolaryngol Relat Spec;;
Orthodontie Francaise=Orthod Fr;;
Orthopade=Orthopade;;
Orthopedic Clinics of North America=Orthop Clin North Am;;
Orthopedics=Orthopedics;;
Orvosi Hetilap=Orv Hetil;;
Osaka City Medical Journal=Osaka City Med J;;
Osteoarthritis and Cartilage=Osteoarthritis Cartilage;;
Osteoporosis International=Osteoporos Int;;
Otolaryngologia Polska=Otolaryngol Pol;;
Otolaryngologic Clinics of North America=Otolaryngol Clin North Am;;
Otolaryngology - Head and Neck Surgery=Otolaryngol Head Neck Surg;;
Oxford Surveys on Eukaryotic Genes=Oxf Surv Eukaryot Genes;;
Pacing and Clinical Electrophysiology=Pacing Clin Electrophysiol;;
Paediatric Anaesthesia=Paediatr Anaesth;;
Paediatric and Perinatal Epidemiology=Paediatr Perinat Epidemiol;;
Pain=Pain;;
Palliative Medicine=Palliat Med;;
Pancreas=Pancreas;;
Panminerva Medica=Panminerva Med;;
Papua New Guinea Medical Journal=P N G Med J;;
Parasite=Parasite;;
Parasite Immunology=Parasite Immunol;;
Parasitology=Parasitology;;
Parasitology Research=Parasitol Res;;
Parassitologia=Parassitologia;;
Parazitologiia=Parazitologiia;;
Pathobiology=Pathobiology;;
Pathologe=Pathologe;;
Pathologica=Pathologica;;
Pathologie Biologie=Pathol Biol (Paris);;
Pathology=Pathology (Phila);;
Pathology=Pathology;;
Pathology International=Pathol Int;;
Pathology, Research and Practice=Pathol Res Pract;;
Patologicheskaia Fiziologiia I Eksperimentalnaia Terapiia=Patol Fiziol Eksp Ter;;
PDA Journal of Pharmaceutical Science and Technology=PDA J Pharm Sci Technol;;
Pediatria Medica E Chirurgica=Pediatr Med Chir;;
Pediatric Allergy and Immunology=Pediatr Allergy Immunol;;
Pediatric Annals=Pediatr Ann;;
Pediatric Cardiology=Pediatr Cardiol;;
Pediatric Clinics of North America=Pediatr Clin North Am;;
Pediatric Dentistry=Pediatr Dent;;
Pediatric Dermatology=Pediatr Dermatol;;
Pediatric Emergency Care=Pediatr Emerg Care;;
Pediatric Hematology and Oncology=Pediatr Hematol Oncol;;
Pediatric Infectious Disease Journal=Pediatr Infect Dis J;;
Pediatric Nephrology=Pediatr Nephrol;;
Pediatric Neurology=Pediatr Neurol;;
Pediatric Neurosurgery=Pediatr Neurosurg;;
Pediatric Pathology and Laboratory Medicine=Pediatr Pathol Lab Med;;
Pediatric Pulmonology=Pediatr Pulmonol;;
Pediatric Pulmonology. Supplement=Pediatr Pulmonol Suppl;;
Pediatric Radiology=Pediatr Radiol;;
Pediatric Research=Pediatr Res;;
Pediatric Surgery International=Pediatr Surg Int;;
Pediatrics=Pediatrics;;
Pediatrics In Review=Pediatr Rev;;
Pennsylvania Medicine=Pa Med;;
Peptides=Peptides;;
Perception=Perception;;
Perceptual and Motor Skills=Percept Mot Skills;;
Perfusion=Perfusion;;
Peritoneal Dialysis International (Downsview, Ontario=Perit Dial Int;;
Perspectives In Biology and Medicine=Perspect Biol Med;;
Perspectives on Developmental Neurobiology=Perspect Dev Neurobiol;;
Pflugers Archiv. European Journal of Physiology=Pflugers Arch;;
Pharmaceutica Acta Helvetiae=Pharm Acta Helv;;
Pharmaceutical Biotechnology=Pharm Biotechnol;;
Pharmaceutical Research=Pharm Res;;
Pharmacogenetics=Pharmacogenetics;;
Pharmacological Research=Pharmacol Res;;
Pharmacological Reviews=Pharmacol Rev;;
Pharmacology=Pharmacology;;
Pharmacology, Biochemistry and Behavior=Pharmacol Biochem Behav;;
Pharmacology and Therapeutics=Pharmacol Ther;;
Pharmacology and Toxicology=Pharmacol Toxicol;;
Pharmacopsychiatry=Pharmacopsychiatry;;
Pharmacotherapy=Pharmacotherapy;;
Pharmacy World and Science=Pharm World Sci;;
Pharmazie=Pharmazie;;
Pharmazie In Unserer Zeit=Pharm Unserer Zeit;;
Pharos of Alpha Omega Alpha Honor Medical Society=Pharos;;
Philosophical Transactions of The Royal Society Of London. Series B: Biological Sciences=Philos Trans R Soc Lond B Biol Sci;;
Phonetica=Phonetica;;
Photochemistry and Photobiology=Photochem Photobiol;;
Photodermatology, Photoimmunology and Photomedicine=Photodermatol Photoimmunol Photomed;;
Physical Medicine and Rehabilitation Clinics of North America=Phys Med Rehabil Clin N Am;;
Physical Therapy=Phys Ther;;
Physics In Medicine and Biology=Phys Med Biol;;
Physiological Chemistry and Physics And Medical NMR=Physiol Chem Phys Med NMR;;
Physiological Measurement=Physiol Meas;;
Physiological Research=Physiol Res;;
Physiological Reviews=Physiol Rev;;
Physiological Zoology=Physiol Zool;;
Physiologist=Physiologist;;
Physiology and Behavior=Physiol Behav;;
Physiotherapy Research International=Physiother Res Int;;
Pigment Cell Research=Pigment Cell Res;;
Placenta=Placenta;;
Plant Cell=Plant Cell;;
Plant and Cell Physiology=Plant Cell Physiol;;
Plant Foods For Human Nutrition=Plant Foods Hum Nutr;;
Plant Journal=Plant J;;
Plant Molecular Biology=Plant Mol Biol;;
Plant Physiology=Plant Physiol;;
Planta Medica=Planta Med;;
Plasmid=Plasmid;;
Plastic and Reconstructive Surgery=Plast Reconstr Surg;;
Pneumoftiziologia=Pneumoftiziologia;;
Pneumologie=Pneumologie;;
Pneumonologia I Alergologia Polska=Pneumonol Alergol Pol;;
Polimery W Medycynie=Polim Med;;
Polish Journal of Pathology=Pol J Pathol;;
Polish Journal of Pharmacology=Pol J Pharmacol;;
Polski Merkuriusz Lekarski=Pol Merkuriusz Lek;;
Polskie Archiwum Medycyny Wewnetrznej=Pol Arch Med Wewn;;
Population Reports. Series A; Oral Contraceptives=Popul Rep A;;
Population Reports. Series B; Intrauterine Devices=Popul Rep B;;
Population Reports. Series C, Female Sterilization=Popul Rep C;;
Population Reports. Series D, Male Sterilization=Popul Rep D;;
Population Reports. Series E; Law and Policy=Popul Rep E;;
Population Reports. Series H; Barrier Methods=Popul Rep H;;
Population Reports. Series J: Family Planning Programs=Popul Rep J;;
Population Reports. Series L: Issues In World Health=Popul Rep L;;
Population Reports. Series M, Special Topics=Popul Rep M;;
Population Trends=Popul Trends;;
Postepy Biochemii=Postepy Biochem;;
Postepy Higieny I Medycyny Doswiadczalnej=Postepy Hig Med Dosw;;
Postgraduate Medical Journal=Postgrad Med J;;
Postgraduate Medicine=Postgrad Med;;
Poultry Science=Poult Sci;;
Practitioner=Practitioner;;
Praxis Der Kinderpsychologie Und Kinderpsychiatrie=Prax Kinderpsychol Kinderpsychiatr;;
Praxis Der Kinderpsychologie Und Kinderpsychiatrie. Beiheft=Prax Kinderpsychol Kinderpsychiatr Beih;;
Prenatal Diagnosis=Prenat Diagn;;
Preparative Biochemistry and Biotechnology=Prep Biochem Biotechnol;;
Presse Medicale=Presse Med;;
Preventive Medicine=Prev Med;;
Preventive Veterinary Medicine=Prev Vet Med;;
Prikladnaia Biokhimiia I Mikrobiologiia=Prikl Biokhim Mikrobiol;;
Primary Care; Clinics In Office Practice=Prim Care;;
Problemi Na Khigienata=Probl Khig;;
Problemy Kosmicheskoi Biologii=Probl Kosm Biol;;
Problemy Medycyny Wieku Rozwojowego=Probl Med Wieku Rozwoj;;
Problemy Sotsialnoi Gigieny I Istoriia Meditsiny=Probl Sotsialnoi Gig Istor Med;;
Problemy Tuberkuleza=Probl Tuberk;;
Proceedings of The Association Of American Physicians=Proc Assoc Am Physicians;;
Proceedings of The Institution Of Mechanical Engineers. Part H, Journal Of Engineering In Medicine=Proc Inst Mech Eng [H];;
Proceedings of The National Academy Of Sciences Of The United States Of America=Proc Natl Acad Sci U S A;;
Proceedings of The National Science Council, Republic Of China. Part B, Life Sciences=Proc Natl Sci Counc Repub China B;;
Proceedings of The Nutrition Society=Proc Nutr Soc;;
Proceedings of The Royal Society Of London. Series B: Biological Sciences=Proc R Soc Lond B Biol Sci;;
Proceedings of The Society For Experimental Biology and Medicine=Proc Soc Exp Biol Med;;
Proceedings of The Western Pharmacology Society=Proc West Pharmacol Soc;;
Progres En Urologie=Prog Urol;;
Progress In AIDS Pathology=Prog AIDS Pathol;;
Progress In Behavior Modification=Prog Behav Modif;;
Progress In Biochemical Pharmacology=Prog Biochem Pharmacol;;
Progress In Biophysics and Molecular Biology=Prog Biophys Mol Biol;;
Progress In Brain Research=Prog Brain Res;;
Progress In Cardiovascular Diseases=Prog Cardiovasc Dis;;
Progress In Cardiovascular Nursing=Prog Cardiovasc Nurs;;
Progress In Clinical and Biological Research=Prog Clin Biol Res;;
Progress In Clinical Parasitology=Prog Clin Parasitol;;
Progress In Drug Research=Prog Drug Res;;
Progress In Experimental Tumor Research=Prog Exp Tumor Res;;
Progress In Histochemistry and Cytochemistry=Prog Histochem Cytochem;;
Progress In Lipid Research=Prog Lipid Res;;
Progress In Liver Diseases=Prog Liver Dis;;
Progress In Medical Virology=Prog Med Virol;;
Progress In Medicinal Chemistry=Prog Med Chem;;
Progress In Molecular and Subcellular Biology=Prog Mol Subcell Biol;;
Progress In Neurobiology=Prog Neurobiol;;
Progress In Neuro-Psychopharmacology and Biological Psychiatry=Prog Neuropsychopharmacol Biol Psychiatry;;
Progress In Nucleic Acid Research and Molecular Biology=Prog Nucleic Acid Res Mol Biol;;
Prostaglandins=Prostaglandins;;
Prostaglandins Leukotrienes and Essential Fatty Acids=Prostaglandins Leukot Essent Fatty Acids;;
Prostate=Prostate;;
Prostate. Supplement=Prostate Suppl;;
Prosthetics and Orthotics International=Prosthet Orthot Int;;
Protein Engineering=Protein Eng;;
Protein Expression and Purification=Protein Expr Purif;;
Protein Science=Protein Sci;;
Proteins=Proteins;;
Przeglad Epidemiologiczny=Przegl Epidemiol;;
Przeglad Lekarski=Przegl Lek;;
Psychiatria Polska=Psychiatr Pol;;
Psychiatric Clinics of North America=Psychiatr Clin North Am;;
Psychiatric Genetics=Psychiatr Genet;;
Psychiatric Quarterly=Psychiatr Q;;
Psychiatric Services=Psychiatr Serv;;
Psychiatrische Praxis=Psychiatr Prax;;
Psychiatry=Psychiatry;;
Psychiatry and Clinical Neurosciences=Psychiatry Clin Neurosci;;
Psychiatry Research=Psychiatry Res;;
Psychoanalytic Quarterly=Psychoanal Q;;
Psychoanalytic Review=Psychoanal Rev;;
Psychoanalytic Study of The Child=Psychoanal Study Child;;
Psychological Bulletin=Psychol Bull;;
Psychological Issues=Psychol Issues;;
Psychological Medicine=Psychol Med;;
Psychological Reports=Psychol Rep;;
Psychological Research=Psychol Res;;
Psychological Review=Psychol Rev;;
Psychology and Aging=Psychol Aging;;
Psychoneuroendocrinology=Psychoneuroendocrinology;;
Psycho-Oncology=Psychooncology;;
Psychopathology=Psychopathology;;
Psychopharmacology=Psychopharmacology (Berl);;
Psychopharmacology Bulletin=Psychopharmacol Bull;;
Psychopharmacology Series=Psychopharmacol Ser;;
Psychophysiology=Psychophysiology;;
Psychosomatic Medicine=Psychosom Med;;
Psychosomatics=Psychosomatics;;
Psychotherapie, Psychosomatik, Medizinische Psychologie=Psychother Psychosom Med Psychol;;
Psychotherapy and Psychosomatics=Psychother Psychosom;;
Pubblicazioni Della Stazione Zoologica di Napoli. Section Ii: History and Philosophy of The Life Sciences=Pubbl Stn Zool Napoli II;;
Public Health=Public Health;;
Public Health Nursing=Public Health Nurs;;
Public Health Reports=Public Health Rep;;
Public Health Reviews=Public Health Rev;;
Puerto Rico Health Sciences Journal=P R Health Sci J;;
Pulmonary Pharmacology and Therapeutics=Pulm Pharmacol Ther;;
QJM=QJM;;
Quality Assurance=Qual Assur;;
Quality of Life Research=Qual Life Res;;
Quarterly Journal of Experimental Psychology. A, Human Experimental Psychology=Q J Exp Psychol A;;
Quarterly Journal of Experimental Psychology. B, Comparative And Physiological Psychology=Q J Exp Psychol B;;
Quarterly Journal of Nuclear Medicine=Q J Nucl Med;;
Quarterly Review of Biology=Q Rev Biol;;
Quarterly Reviews of Biophysics=Q Rev Biophys;;
Radiation and Environmental Biophysics=Radiat Environ Biophys;;
Radiation Medicine=Radiat Med;;
Radiation Oncology Investigations=Radiat Oncol Investig;;
Radiation Research=Radiat Res;;
Radiatsionnaia Biologiia, Radioecologiia=Radiats Biol Radioecol;;
Radiographics=Radiographics;;
Radiologe=Radiologe;;
Radiologia Medica=Radiol Med (Torino);;
Radiologic Clinics of North America=Radiol Clin North Am;;
Radiologic Technology=Radiol Technol;;
Radiology=Radiology;;
Radiotherapy and Oncology=Radiother Oncol;;
Rapid Communications In Mass Spectrometry=Rapid Commun Mass Spectrom;;
Rays=Rays;;
Recent Developments In Alcoholism=Recent Dev Alcohol;;
Recent Progress In Hormone Research=Recent Prog Horm Res;;
Recent Results In Cancer Research=Recent Results Cancer Res;;
Recenti Progressi In Medicina=Recenti Prog Med;;
Receptors and Channels=Receptors Channels;;
Receptors and Signal Transduction=Recept Signal Transduct;;
Reconstruction Surgery and Traumatology=Reconstr Surg Traumatol;;
Regional Anesthesia=Reg Anesth;;
Regulatory Peptides=Regul Pept;;
Regulatory Toxicology and Pharmacology=Regul Toxicol Pharmacol;;
Rehabilitation=Rehabilitation (Stuttg);;
Renal Failure=Ren Fail;;
Report / Group For The Advancement of Psychiatry=Rep Group Adv Psychiatry;;
Reports on Health and Social Subjects=Rep Health Soc Subj (Lond);;
Reproduction, Fertility, and Development=Reprod Fertil Dev;;
Reproduction, Nutrition, Development=Reprod Nutr Dev;;
Reproductive Toxicology=Reprod Toxicol;;
Research Communications In Molecular Pathology and Pharmacology=Res Commun Mol Pathol Pharmacol;;
Research In Developmental Disabilities=Res Dev Disabil;;
Research In Experimental Medicine=Res Exp Med (Berl);;
Research In Immunology=Res Immunol;;
Research In Microbiology=Res Microbiol;;
Research In Nursing and Health=Res Nurs Health;;
Research Quarterly For Exercise and Sport=Res Q Exerc Sport;;
Research Report / Health Effects Institute=Res Rep Health Eff Inst;;
Research In Veterinary Science=Res Vet Sci;;
Research In Virology=Res Virol;;
Respiration=Respiration;;
Respiration Physiology=Respir Physiol;;
Respiratory Care Clinics of North America=Respir Care Clin N Am;;
Respiratory Medicine=Respir Med;;
Respirology=Respirology;;
Results and Problems In Cell Differentiation=Results Probl Cell Differ;;
Resuscitation=Resuscitation;;
Retina=Retina;;
Reumatizam=Reumatizam;;
Reviews of Environmental Contamination and Toxicology=Rev Environ Contam Toxicol;;
Reviews on Environmental Health=Rev Environ Health;;
Reviews In The Neurosciences=Rev Neurosci;;
Reviews of Oculomotor Research=Rev Oculomot Res;;
Reviews of Physiology Biochemistry and Pharmacology=Rev Physiol Biochem Pharmacol;;
Reviews of Reproduction=Rev Reprod;;
Revista Argentina de Microbiologia=Rev Argent Microbiol;;
Revista Da Associacao Medica Brasileira=Rev Assoc Med Bras;;
Revista de Biologia Tropical=Rev Biol Trop;;
Revista Brasileira de Biologia=Rev Bras Biol;;
Revista Clinica Espanola=Rev Clin Esp;;
Revista Cubana de Medicina Tropical=Rev Cubana Med Trop;;
Revista Espanola de Anestesiologia Y Reanimacion=Rev Esp Anestesiol Reanim;;
Revista Espanola de Cardiologia=Rev Esp Cardiol;;
Revista Espanola de Enfermedades Digestivas=Rev Esp Enferm Dig;;
Revista Espanola de Fisiologia=Rev Esp Fisiol;;
Revista Espanola de Salud Publica=Rev Esp Salud Publica;;
Revista de la Facultad De Ciencias Medicas / Universidad Nacional De Cordoba=Rev Fac Cien Med Univ Nac Cordoba;;
Revista de Gastroenterologia De Mexico=Rev Gastroenterol Mex;;
Revista Do Hospital Das Clinicas; Faculdade de Medicina Da Universidade De Sao Paulo=Rev Hosp Clin Fac Med Sao Paulo;;
Revista Do Instituto de Medicina Tropical De Sao Paulo=Rev Inst Med Trop Sao Paulo;;
Revista de Investigacion Clinica=Rev Invest Clin;;
Revista Latinoamericana de Microbiologia=Rev Latinoam Microbiol;;
Revista Medica de Chile=Rev Med Chil;;
Revista Medica de Panama=Rev Med Panama;;
Revista de Medicina De la Universidad De Navarra=Rev Med Univ Navarra;;
Revista Medico-Chirurgicala A Societatii de Medici Si Naturalisti Din Iasi=Rev Med Chir Soc Med Nat Iasi;;
Revista de Neurologia=Rev Neurol;;
Revista Panamericana de Salud Publica=Rev Panam Salud Publica;;
Revista Paulista de Medicina=Rev Paul Med;;
Revista Portuguesa de Cardiologia=Rev Port Cardiol;;
Revista de Saude Publica=Rev Saude Publica;;
Revista Da Sociedade Brasileira de Medicina Tropical=Rev Soc Bras Med Trop;;
Revue Belge de Medecine Dentaire=Rev Belge Med Dent;;
Revue de Chirurgie Orthopedique Et Reparatrice De L Appareil Moteur=Rev Chir Orthop Reparatrice Appar Mot;;
Revue D Epidemiologie Et de Sante Publique=Rev Epidemiol Sante Publique;;
Revue Internationale Du Trachome Et de Pathologie Oculaire Tropicale EtSubtropicale Et De Sante Publique Rev Int Trach Pathol Ocul Trop Subtro=Sante Publique;;
Revue de Laryngologie Otologie Rhinologie=Rev Laryngol Otol Rhinol (Bord);;
Revue Des Maladies Respiratoires=Rev Mal Respir;;
Revue de Medecine Interne=Rev Med Interne;;
Revue Medicale de Bruxelles=Rev Med Brux;;
Revue Medicale de Liege=Rev Med Liege;;
Revue Medicale de la Suisse Romande=Rev Med Suisse Romande;;
Revue Neurologique=Rev Neurol (Paris);;
Revue de Pneumologie Clinique=Rev Pneumol Clin;;
Revue Du Rhumatisme. English Edition=Rev Rhum Engl Ed;;
Revue Scientifique Et Technique=Rev Sci Tech;;
Revue de Stomatologie Et De Chirurgie Maxillo-Faciale=Rev Stomatol Chir Maxillofac;;
Rheumatic Diseases Clinics of North America=Rheum Dis Clin North Am;;
Rheumatology International=Rheumatol Int;;
Rhinology=Rhinology;;
Rhinology. Supplement=Rhinol Suppl;;
Rinsho Byori. Japanese Journal of Clinical Pathology=Rinsho Byori;;
Rinsho Ketsueki. Japanese Journal of Clinical Hematology=Rinsho Ketsueki;;
Rinsho Shinkeigaku. Clinical Neurology=Rinsho Shinkeigaku;;
Risk Analysis=Risk Anal;;
Rivista di Biologia=Riv Biol;;
RNA=RNA;;
Roczniki Akademii Medycznej W Bialymstoku=Rocz Akad Med Bialymst;;
Roczniki Panstwowego Zakladu Higieny=Rocz Panstw Zakl Hig;;
Rofo. Fortschritte Auf Dem Gebiete Der Rontgenstrahlen Und Der NeuenBildgebenden Verfahren Rofo Fortschr Geb Rontgenstr Neuen Bildge=Verfahr;;
Romanian Journal of Internal Medicine=Rom J Intern Med;;
Romanian Journal of Morphology and Embryology=Rom J Morphol Embryol;;
Romanian Journal of Virology=Rom J Virol;;
Rontgenpraxis=Rontgenpraxis;;
Roumanian Archives of Microbiology and Immunology=Roum Arch Microbiol Immunol;;
Rozhledy V Chirurgii=Rozhl Chir;;
Ryumachi=Ryumachi;;
Salud Publica de Mexico=Salud Publica Mex;;
Sangre=Sangre (Barc);;
Sangyo Eiseigaku Zasshi=Sangyo Eiseigaku Zasshi;;
Sangyo Ika Daigaku Zasshi=Sangyo Ika Daigaku Zasshi;;
Sante=Sante;;
Sante Publique (Vandoeuvre-Les-Nancy=Sante Publique;;
Sar and QSAR In Environmental Research=SAR QSAR Environ Res;;
Sarcoidosis, Vasculitis, and Diffuse Lung Diseases=Sarcoidosis Vasc Diffuse Lung Dis;;
Sbornik Lekarsky=Sb Lek;;
Scandinavian Audiology=Scand Audiol;;
Scandinavian Audiology. Supplementum=Scand Audiol Suppl;;
Scandinavian Cardiovascular Journal=Scand Cardiovasc J;;
Scandinavian Cardiovascular Journal. Supplement=Scand Cardiovasc J Suppl;;
Scandinavian Journal of Clinical and Laboratory Investigation=Scand J Clin Lab Invest;;
Scandinavian Journal of Clinical and Laboratory Investigation. Supplement=Scand J Clin Lab Invest Suppl;;
Scandinavian Journal of Gastroenterology=Scand J Gastroenterol;;
Scandinavian Journal of Gastroenterology. Supplement=Scand J Gastroenterol Suppl;;
Scandinavian Journal of Immunology=Scand J Immunol;;
Scandinavian Journal of Immunology. Supplement=Scand J Immunol Suppl;;
Scandinavian Journal of Infectious Diseases=Scand J Infect Dis;;
Scandinavian Journal of Infectious Diseases. Supplementum=Scand J Infect Dis Suppl;;
Scandinavian Journal of Medicine and Science In Sports=Scand J Med Sci Sports;;
Scandinavian Journal of Plastic and Reconstructive Surgery And Hand Surgery=Scand J Plast Reconstr Surg Hand Surg;;
Scandinavian Journal of Plastic and Reconstructive Surgery And Hand Surgery. Supplementum=Scand J Plast Reconstr Surg Hand Surg Suppl;;
Scandinavian Journal of Primary Health Care=Scand J Prim Health Care;;
Scandinavian Journal of Primary Health Care. Supplement=Scand J Prim Health Care Suppl;;
Scandinavian Journal of Psychology=Scand J Psychol;;
Scandinavian Journal of Rehabilitation Medicine=Scand J Rehabil Med;;
Scandinavian Journal of Rehabilitation Medicine. Supplement=Scand J Rehabil Med Suppl;;
Scandinavian Journal of Rheumatology=Scand J Rheumatol;;
Scandinavian Journal of Rheumatology. Supplement=Scand J Rheumatol Suppl;;
Scandinavian Journal of Social Medicine=Scand J Soc Med;;
Scandinavian Journal of Social Medicine. Supplementum=Scand J Soc Med Suppl;;
Scandinavian Journal of Urology and Nephrology=Scand J Urol Nephrol;;
Scandinavian Journal of Urology and Nephrology. Supplementum=Scand J Urol Nephrol Suppl;;
Scandinavian Journal of Work, Environment and Health=Scand J Work Environ Health;;
Scanning=Scanning;;
Scanning Microscopy (Elk Grove Village, Il=Scanning Microsc;;
Scanning Microscopy. Supplement=Scanning Microsc Suppl;;
Schizophrenia Bulletin=Schizophr Bull;;
Schizophrenia Research=Schizophr Res;;
Scholarly Inquiry For Nursing Practice=Sch Inq Nurs Pract;;
Schriftenreihe Neurologie. Neurology Series=Schriftenr Neurol;;
Schriftenreihe Des Vereins Fur Wasser-, Boden-, Und Lufthygiene=Schriftenr Ver Wasser Boden Lufthyg;;
Schweizer Archiv Fur Tierheilkunde=Schweiz Arch Tierheilkd;;
Schweizer Monatsschrift Fur Zahnmedizin=Schweiz Monatsschr Zahnmed;;
Schweizerische Medizinische Wochenschrift. Journal Suisse de Medecine=Schweiz Med Wochenschr;;
Schweizerische Medizinische Wochenschrift. Supplementum=Schweiz Med Wochenschr Suppl;;
Schweizerische Rundschau Fur Medizin Praxis=Schweiz Rundsch Med Prax;;
Science=Science;;
Science In China. Series C, Life Sciences=Sci China C Life Sci;;
Science and Justice=Sci Justice;;
Science Progress=Sci Prog;;
Science of The Total Environment=Sci Total Environ;;
Scientific American=Sci Am;;
Scottish Medical Journal=Scott Med J;;
Se Pu Chinese Journal of Chromatography (Ta-Lien Shih=Se Pu;;
Seikagaku. Journal of Japanese Biochemical Society=Seikagaku;;
Seishin Shinkeigaku Zasshi. Psychiatria Et Neurologia Japonica=Seishin Shinkeigaku Zasshi;;
Seizure=Seizure;;
Seminars In Arthritis and Rheumatism=Semin Arthritis Rheum;;
Seminars In Cancer Biology=Semin Cancer Biol;;
Seminars In Cutaneous Medicine and Surgery=Semin Cutan Med Surg;;
Seminars In Diagnostic Pathology=Semin Diagn Pathol;;
Seminars In Gastrointestinal Disease=Semin Gastrointest Dis;;
Seminars In Hematology=Semin Hematol;;
Seminars In Immunology=Semin Immunol;;
Seminars In Liver Disease=Semin Liver Dis;;
Seminars In Nephrology=Semin Nephrol;;
Seminars In Neurology=Semin Neurol;;
Seminars In Nuclear Medicine=Semin Nucl Med;;
Seminars In Oncology=Semin Oncol;;
Seminars In Oncology Nursing=Semin Oncol Nurs;;
Seminars In Pediatric Neurology=Semin Pediatr Neurol;;
Seminars In Pediatric Surgery=Semin Pediatr Surg;;
Seminars In Perinatology=Semin Perinatol;;
Seminars In Reproductive Endocrinology=Semin Reprod Endocrinol;;
Seminars In Respiratory Infections=Semin Respir Infect;;
Seminars In Roentgenology=Semin Roentgenol;;
Seminars In Speech and Language=Semin Speech Lang;;
Seminars In Surgical Oncology (New York, Ny=Semin Surg Oncol;;
Seminars In Thoracic and Cardiovascular Surgery=Semin Thorac Cardiovasc Surg;;
Seminars In Thrombosis and Hemostasis=Semin Thromb Hemost;;
Seminars In Ultrasound, Ct and Mr=Semin Ultrasound CT MR;;
Seminars In Urologic Oncology=Semin Urol Oncol;;
Seminars In Vascular Surgery=Semin Vasc Surg;;
Sexually Transmitted Diseases=Sex Transm Dis;;
Sexually Transmitted Infections=Sex Transm Infect;;
Sheng Li Hsueh Pao [Acta Physiologica Sinica]=Sheng Li Hsueh Pao;;
Sheng Li Ko Hsueh Chin Chan [Progress In Physiological Sciences]=Sheng Li Ko Hsueh Chin Chan;;
Sheng Wu I Hsueh Kung Cheng Hsueh Tsa Chih Journal of Biomedical Engineering (Cheng-Tu=Sheng Wu I Hsueh Kung Cheng Hsueh Tsa Chih;;
Shih Yen Sheng Wu Hsueh Pao Journal of Experimental Biology=Shih Yen Sheng Wu Hsueh Pao;;
Shinrigaku Kenkyu. Japanese Journal of Psychology=Shinrigaku Kenkyu;;
Shock=Shock;;
Singapore Medical Journal=Singapore Med J;;
Skeletal Radiology=Skeletal Radiol;;
Skin Pharmacology=Skin Pharmacol;;
Sleep=Sleep;;
Social Biology=Soc Biol;;
Social Psychiatry and Psychiatric Epidemiology=Soc Psychiatry Psychiatr Epidemiol;;
Social Science and Medicine=Soc Sci Med;;
Social Security Bulletin=Soc Secur Bull;;
Social Work=Soc Work;;
Social Work In Health Care=Soc Work Health Care;;
Society For Applied Bacteriology Symposium Series=Soc Appl Bacteriol Symp Ser;;
Society of General Physiologists Series=Soc Gen Physiol Ser;;
Solid State Nuclear Magnetic Resonance=Solid State Nucl Magn Reson;;
Somatic Cell and Molecular Genetics=Somat Cell Mol Genet;;
Somatosensory and Motor Research=Somatosens Mot Res;;
Soudni Lekarstvi=Soud Lek;;
South African Journal of Communication Disorders. Die Suid-Afrikaanse Tydskrif Vir Kommunikasieafwykings=S Afr J Commun Disord;;
South African Journal of Surgery=S Afr J Surg;;
South African Medical Journal=S Afr Med J;;
South Dakota Journal of Medicine=S D J Med;;
Southeast Asian Journal of Tropical Medicine and Public Health=Southeast Asian J Trop Med Public Health;;
Southern Medical Journal=South Med J;;
Sozial- Und Praventivmedizin=Soz Praventivmed;;
Spatial Vision=Spat Vis;;
Spinal Cord=Spinal Cord;;
Spine=Spine;;
Sports Medicine=Sports Med;;
Sportverletzung Sportschaden=Sportverletz Sportschaden;;
Springer Seminars In Immunopathology=Springer Semin Immunopathol;;
Srpski Arhiv Za Celokupno Lekarstvo=Srp Arh Celok Lek;;
Statistical Bulletin / Metropolitan Insurance Companies=Stat Bull Metrop Insur Co;;
Statistical Methods In Medical Research=Stat Methods Med Res;;
Statistics In Medicine=Stat Med;;
Stem Cells=Stem Cells;;
Stereotactic and Functional Neurosurgery=Stereotact Funct Neurosurg;;
Steroids=Steroids;;
Stomatologiia=Stomatologiia (Mosk);;
Strahlentherapie Und Onkologie=Strahlenther Onkol;;
Stroke=Stroke;;
Structure=Structure;;
Studies In Family Planning=Stud Fam Plann;;
Studies In Human Ecology=Stud Hum Ecol;;
Sub-Cellular Biochemistry=Subcell Biochem;;
Substance Use and Misuse=Subst Use Misuse;;
Sudebno-Meditsinskaia Ekspertiza=Sud Med Ekspert;;
Sudhoffs Archiv; Zeitschrift Fur Wissenschaftsgeschichte=Sudhoffs Arch Z Wissenschaftsgesch;;
Sudhoffs Archiv; Zeitschrift Fur Wissenschaftsgeschichte. Beihefte=Sudhoffs Arch Z Wissenschaftsgesch Beih;;
Suicide and Life-Threatening Behavior=Suicide Life Threat Behav;;
Supplement To The European Journal Neuroscience=Suppl Eur J Neurosci;;
Supportive Care In Cancer=Support Care Cancer;;
Surgery=Surgery;;
Surgery Today=Surg Today;;
Surgical Clinics of North America=Surg Clin North Am;;
Surgical Endoscopy=Surg Endosc;;
Surgical Laparoscopy and Endoscopy=Surg Laparosc Endosc;;
Surgical Neurology=Surg Neurol;;
Surgical Oncology=Surg Oncol;;
Surgical Oncology Clinics of North America=Surg Oncol Clin N Am;;
Surgical and Radiologic Anatomy=Surg Radiol Anat;;
Survey of Ophthalmology=Surv Ophthalmol;;
Swedish Dental Journal=Swed Dent J;;
Swedish Dental Journal. Supplement=Swed Dent J Suppl;;
Swiss Surgery=Swiss Surg;;
Symposia of The Society For Experimental Biology=Symp Soc Exp Biol;;
Synapse=Synapse;;
Systematic Biology=Syst Biol;;
Tanpakushitsu Kakusan Koso. Protein, Nucleic Acid, Enzyme=Tanpakushitsu Kakusan Koso;;
Targeted Diagnosis and Therapy=Targeted Diagn Ther;;
Techniques In Urology=Tech Urol;;
Technology and Health Care=Technol Health Care;;
Tennessee Medicine=Tenn Med;;
Terapevticheskii Arkhiv=Ter Arkh;;
Teratogenesis, Carcinogenesis, and Mutagenesis=Teratog Carcinog Mutagen;;
Teratology=Teratology;;
Texas Heart Institute Journal=Tex Heart Inst J;;
Texas Medicine=Tex Med;;
Theoretical Medicine and Bioethics=Theor Med Bioeth;;
Theoretical Population Biology=Theor Popul Biol;;
Therapeutic Drug Monitoring=Ther Drug Monit;;
Therapeutic Immunology=Ther Immunol;;
Therapeutische Umschau=Ther Umsch;;
Therapie=Therapie;;
Thoracic and Cardiovascular Surgeon=Thorac Cardiovasc Surg;;
Thorax=Thorax;;
Thrombosis and Haemostasis=Thromb Haemost;;
Thrombosis Research=Thromb Res;;
Thyroid=Thyroid;;
Tidsskrift For Den Norske Laegeforening=Tidsskr Nor Laegeforen;;
Tierarztliche Praxis. Ausgabe G, Grosstiere Nutztiere=Tierarztl Prax Ausg G Grosstiere Nutztiere;;
Tierarztliche Praxis. Ausgabe K, Kleintiere/Heimtiere=Tierarztl Prax Ausg K Klientiere Heimtiere;;
Tierarztliche Praxis. Supplement=Tierarztl Prax Suppl;;
Tijdschrift Voor Diergeneeskunde=Tijdschr Diergeneeskd;;
Tijdschrift Voor Gerontologie En Geriatrie=Tijdschr Gerontol Geriatr;;
Tissue Antigens=Tissue Antigens;;
Tissue and Cell=Tissue Cell;;
Tobacco Control=Tob Control;;
Tohoku Journal of Experimental Medicine=Tohoku J Exp Med;;
Tokai Journal of Experimental and Clinical Medicine=Tokai J Exp Clin Med;;
Topics In Magnetic Resonance IMAging=Top Magn Reson Imaging;;
Toxicologic Pathology=Toxicol Pathol;;
Toxicological Sciences=Toxicol Sci;;
Toxicology=Toxicology;;
Toxicology and Applied Pharmacology=Toxicol Appl Pharmacol;;
Toxicology and Industrial Health=Toxicol Ind Health;;
Toxicology Letters=Toxicol Lett;;
Toxicon=Toxicon;;
Transactions of The American Clinical and Climatological Association=Trans Am Clin Climatol Assoc;;
Transactions of The American Ophthalmological Society=Trans Am Ophthalmol Soc;;
Transactions of The Medical Society Of London=Trans Med Soc Lond;;
Transactions of The Royal Society Of Tropical Medicine and Hygiene=Trans R Soc Trop Med Hyg;;
Transactions and Studies of The College Of Physicians Of Philadelphia=Trans Stud Coll Physicians Phila;;
Transfusion=Transfusion;;
Transfusion Clinique Et Biologique=Transfus Clin Biol;;
Transfusion Medicine=Transfus Med;;
Transfusion Medicine Reviews=Transfus Med Rev;;
Transgenic Research=Transgenic Res;;
Transplant Immunology=Transpl Immunol;;
Transplant International=Transpl Int;;
Transplantation=Transplantation;;
Transplantation Proceedings=Transplant Proc;;
Trends In Biochemical Sciences (Cambridge=Trends Biochem Sci;;
Trends In Genetics=Trends Genet;;
Trends In Microbiology=Trends Microbiol;;
Trends In Neurosciences=Trends Neurosci;;
Trends In Pharmacological Sciences=Trends Pharmacol Sci;;
Tropical Animal Health and Production=Trop Anim Health Prod;;
Tropical Doctor=Trop Doct;;
Tropical Gastroenterology=Trop Gastroenterol;;
Tropical Medicine and International Health=Trop Med Int Health;;
Tsitologiia=Tsitologiia;;
Tsitologiia I Genetika=Tsitol Genet;;
Tubercle and Lung Disease=Tuber Lung Dis;;
Tumori=Tumori;;
Tumour Biology=Tumour Biol;;
Tunisie Medicale=Tunis Med;;
Turkish Journal of Pediatrics=Turk J Pediatr;;
Ugeskrift For Laeger=Ugeskr Laeger;;
Uirusu=Uirusu;;
Ukrainskii Biokhimicheskii Zhurnal=Ukr Biokhim Zh;;
Ulster Medical Journal=Ulster Med J;;
Ultramicroscopy=Ultramicroscopy;;
Ultraschall In Der Medizin=Ultraschall Med;;
Ultrasonic IMAging=Ultrason Imaging;;
Ultrasonics=Ultrasonics;;
Ultrasonics Sonochemistry=Ultrason Sonochem;;
Ultrasound In Medicine and Biology=Ultrasound Med Biol;;
Ultrasound In Obstetrics and Gynecology=Ultrasound Obstet Gynecol;;
Ultrastructural Pathology=Ultrastruct Pathol;;
Undersea and Hyperbaric Medicine=Undersea Hyperb Med;;
Unfallchirurg=Unfallchirurg;;
Unfallchirurgie=Unfallchirurgie;;
Union Medicale Du Canada=Union Med Can;;
Upsala Journal of Medical Sciences=Ups J Med Sci;;
Upsala Journal of Medical Sciences. Supplement=Ups J Med Sci Suppl;;
Urologe. Ausgabe A=Urologe A;;
Urologia Internationalis=Urol Int;;
Urologic Clinics of North America=Urol Clin North Am;;
Urological Research=Urol Res;;
Urologiia I Nefrologiia=Urol Nefrol (Mosk);;
Urology=Urology;;
Uspekhi Fiziologicheskikh Nauk=Usp Fiziol Nauk;;
Vaccine=Vaccine;;
Vasa=Vasa;;
Verhandelingen - Koninklijke Academie Voor Geneeskunde Van Belgie=Verh K Acad Geneeskd Belg;;
Verhandlungen Der Deutschen Gesellschaft Fur Pathologie=Verh Dtsch Ges Pathol;;
Veroffentlichungen Aus Der Pathologie=Veroff Pathol;;
Versicherungsmedizin=Versicherungsmedizin;;
Vestnik Khirurgii Imeni I. I. Grekova=Vestn Khir Im I I Grek;;
Vestnik Oftalmologii=Vestn Oftalmol;;
Vestnik Otorinolaringologii=Vestn Otorinolaringol;;
Vestnik Rentgenologii I Radiologii=Vestn Rentgenol Radiol;;
Vestnik Rossiiskoi Akademii Meditsinskikh Nauk=Vestn Ross Akad Med Nauk;;
Veterinary Clinics of North America. Equine Practice=Vet Clin North Am Equine Pract;;
Veterinary Clinics of North America. Food Animal Practice=Vet Clin North Am Food Anim Pract;;
Veterinary Clinics of North America. Small Animal Practice=Vet Clin North Am Small Anim Pract;;
Veterinary and Human Toxicology=Vet Hum Toxicol;;
Veterinary Immunology and Immunopathology=Vet Immunol Immunopathol;;
Veterinary Journal=Vet J;;
Veterinary Microbiology=Vet Microbiol;;
Veterinary Parasitology=Vet Parasitol;;
Veterinary Pathology=Vet Pathol;;
Veterinary Quarterly=Vet Q;;
Veterinary Radiology and Ultrasound=Vet Radiol Ultrasound;;
Veterinary Record=Vet Rec;;
Veterinary Research=Vet Res;;
Veterinary Research Communications=Vet Res Commun;;
Veterinary Surgery=Vet Surg;;
Violence and Victims=Violence Vict;;
Viral Immunology=Viral Immunol;;
Virchows Archiv=Virchows Arch;;
Virginia Medical Quarterly=Va Med Q;;
Virology=Virology;;
Virus Genes=Virus Genes;;
Virus Research=Virus Res;;
Virus Research. Supplement=Virus Res Suppl;;
Vision Research=Vision Res;;
Visual Neuroscience=Vis Neurosci;;
Vital and Health Statistics. Series 1: Programs And Collection Procedures=Vital Health Stat 1;;
Vital and Health Statistics. Series 2: Data Evaluation And Methods Research=Vital Health Stat 2;;
Vital and Health Statistics. Series 3: Analytical And Epidemiological Studies=Vital Health Stat 3;;
Vital and Health Statistics. Series 4: Documents And Committee Reports=Vital Health Stat 4;;
Vital and Health Statistics. Series 5: Comparative International Vital And Health Statistics Reports=Vital Health Stat 5;;
Vital and Health Statistics. Series 10: Data From The National Health Survey=Vital Health Stat 10;;
Vital and Health Statistics. Series 11: Data From The National Health Survey=Vital Health Stat 11;;
Vital and Health Statistics. Series 13: Data From The National Health Survey=Vital Health Stat 13;;
Vital and Health Statistics. Series 14: Data From The National Health Survey=Vital Health Stat 14;;
Vital and Health Statistics. Series 20: Data From The National VitalStatistics System Vital Health Stat 20 Data Natl Vital Sta=Syst;;
Vital and Health Statistics. Series 21: Data on Natality, Marriage, And Divorce=Vital Health Stat 21;;
Vital and Health Statistics. Series 23: Data From The National Survey of Family Growth=Vital Health Stat 23;;
Vitamins and Hormones=Vitam Horm;;
Vnitrni Lekarstvi=Vnitr Lek;;
Voenno-Meditsinskii Zhurnal=Voen Med Zh;;
Vojnosanitetski Pregled=Vojnosanit Pregl;;
Voprosy Kurortologii, Fizioterapii I Lechebnoi Fizicheskoi Kultury=Vopr Kurortol Fizioter Lech Fiz Kult;;
Voprosy Meditsinskoi Khimii=Vopr Med Khim;;
Voprosy Onkologii=Vopr Onkol;;
Voprosy Pitaniia=Vopr Pitan;;
Voprosy Virusologii=Vopr Virusol;;
Vox Sanguinis=Vox Sang;;
Weekly Epidemiological Record=Wkly Epidemiol Rec;;
Wei Sheng Wu Hsueh Pao [Acta Microbiologica Sinica]=Wei Sheng Wu Hsueh Pao;;
Wei Sheng Yen Chiu Journal of Hygiene Research (Pei-Ching Shih=Wei Sheng Yen Chiu;;
West African Journal of Medicine=West Afr J Med;;
West Indian Medical Journal=West Indian Med J;;
West Virginia Medical Journal=W V Med J;;
Western Journal of Medicine=West J Med;;
Western Journal of Nursing Research=West J Nurs Res;;
WHO Regional Publications. European Series=WHO Reg Publ Eur Ser;;
Wiadomosci Lekarskie=Wiad Lek;;
Wiadomosci Parazytologiczne=Wiad Parazytol;;
Wiener Klinische Wochenschrift=Wien Klin Wochenschr;;
Wiener Klinische Wochenschrift. Supplementum=Wien Klin Wochenschr Suppl;;
Wiener Medizinische Wochenschrift=Wien Med Wochenschr;;
Wiener Medizinische Wochenschrift.Supplement=Wien Med Wochenschr Suppl;;
Women and Health=Women Health;;
Womens Health=Womens Health;;
Womens Health Issues=Womens Health Issues;;
World Health Forum=World Health Forum;;
World Health Organization Technical Report Series=World Health Organ Tech Rep Ser;;
World Health Statistics Quarterly. Rapport Trimestriel de Statistiques Sanitaires Mondiales=World Health Stat Q;;
World Journal of Surgery=World J Surg;;
World Journal of Urology=World J Urol;;
World Review of Nutrition and Dietetics=World Rev Nutr Diet;;
Xenobiotica=Xenobiotica;;
Yakugaku Zasshi. Journal of The Pharmaceutical Society Of Japan=Yakugaku Zasshi;;
Yale Journal of Biology and Medicine=Yale J Biol Med;;
Yao Hsueh Hsueh Pao [Acta Pharmaceutica Sinica]=Yao Hsueh Hsueh Pao;;
Yeast=Yeast;;
Yen Ko Hsueh Pao [Eye Science] (Chung-Kuo Kuang-Chou=Yen Ko Hsueh Pao;;
Yonsei Medical Journal=Yonsei Med J;;
Zeitschrift Fur Arztliche Fortbildung Und Qualitatssicherung=Z Arztl Fortbild Qualitatssich;;
Zeitschrift Fur Ernahrungswissenschaft=Z Ernahrungswiss;;
Zeitschrift Fur Gastroenterologie=Z Gastroenterol;;
Zeitschrift Fur Geburtshilfe Und Neonatologie=Z Geburtshilfe Neonatol;;
Zeitschrift Fur Gerontologie Und Geriatrie=Z Gerontol Geriatr;;
Zeitschrift Fur Kardiologie=Z Kardiol;;
Zeitschrift Fur Kinder- Und Jugendpsychiatrie=Z Kinder Jugenpsychiatr;;
Zeitschrift Fur Morphologie Und Anthropologie=Z Morphol Anthropol;;
Zeitschrift Fur Naturforschung. Section C. Journal of Biosciences=Z Naturforsch [C];;
Zeitschrift Fur Orthopadie Und Ihre Grenzgebiete=Z Orthop Ihre Grenzgeb;;
Zeitschrift Fur Rheumatologie=Z Rheumatol;;
Zentralblatt Fur Bakteriologie=Zentralbl Bakteriol;;
Zentralblatt Fur Chirurgie=Zentralbl Chir;;
Zentralblatt Fur Gynakologie=Zentralbl Gynakol;;
Zentralblatt Fur Hygiene Und Umweltmedizin=Zentralbl Hyg Umweltmed;;
Zentralblatt Fur Neurochirurgie=Zentralbl Neurochir;;
Zentralblatt Fur Veterinarmedizin. Reihe A=Zentralbl Veterinarmed A;;
Zentralblatt Fur Veterinarmedizin. Reihe B=Zentralbl Veterinarmed [B];;
Zhurnal Evoliutsionnoi Biokhimii I Fiziologii=Zh Evol Biokhim Fiziol;;
Zhurnal Mikrobiologii, Epidemiologii I Immunobiologii=Zh Mikrobiol Epidemiol Immunobiol;;
Zhurnal Obshchei Biologii=Zh Obshch Biol;;
Zhurnal Voprosy Neirokhirurgii Imeni N. N. Burdenko=Zh Vopr Neirokhir Im N N Burdenko;;
Zhurnal Vysshei Nervnoi Deiatelnosti Imeni I. P. Pavlova=Zh Vyssh Nerv Deiat Im I P Pavlova;;
Zygote=Zygote;;
